,index,userid,age,dob_day,dob_year,dob_month,gender,tenure,friend_count,friendships_initiated,likes,likes_received,mobile_likes,mobile_likes_received,www_likes,www_likes_received,viable_candidate
0,53460,1576816,21,5,1992,4,female,603.0,95,18,2,3,2,2,0,1,1
1,276,1908036,19,5,1994,4,male,2.0,0,0,0,0,0,0,0,0,0
2,53436,1710170,14,5,1999,2,male,82.0,96,88,2,0,2,0,0,0,1
3,59694,2015007,17,26,1996,7,male,224.0,117,96,12,7,12,7,0,0,0
4,66082,1189104,20,26,1993,7,male,90.0,148,132,247,25,243,15,4,10,1
5,31476,1299479,63,27,1950,11,male,646.0,43,14,0,0,0,0,0,0,1
6,27658,2034819,65,2,1948,1,female,309.0,35,30,496,15,493,12,3,3,0
7,34487,1070449,18,18,1995,12,male,85.0,48,36,0,0,0,0,0,0,1
8,27572,2099233,59,26,1954,12,female,1752.0,35,6,114,87,0,49,114,38,1
9,33004,2039556,50,2,1963,9,male,393.0,45,33,13,0,11,0,2,0,1
10,46575,1423692,44,1,1969,5,male,873.0,75,29,1,1,1,1,0,0,0
11,36765,1146592,102,1,1911,1,female,1845.0,52,11,2,5,1,3,1,2,1
12,42467,1568736,16,30,1997,12,female,188.0,66,36,0,1,0,0,0,1,0
13,6215,1958889,16,7,1997,3,male,534.0,4,3,1,0,1,0,0,0,1
14,24338,1928117,57,28,1956,8,female,207.0,29,19,74,31,74,29,0,2,0
15,87699,1820758,23,9,1990,2,female,1435.0,385,257,110,69,106,38,4,31,0
16,84019,1746941,14,8,1999,4,female,131.0,310,212,572,386,392,174,180,212,0
17,51558,1166612,21,22,1992,2,male,117.0,88,86,3,7,3,6,0,1,1
18,5748,1148642,26,24,1987,1,male,60.0,3,2,342,0,342,0,0,0,1
19,20408,1377994,49,25,1964,3,male,134.0,24,17,58,3,58,3,0,0,0
20,59965,1185301,36,28,1977,9,female,591.0,117,53,72,169,31,87,41,82,0
21,5897,1680250,24,1,1989,1,male,75.0,4,3,0,0,0,0,0,0,0
22,45352,1764046,49,7,1964,7,male,590.0,71,19,1,0,1,0,0,0,0
23,54812,1311383,15,10,1998,9,male,82.0,98,80,18,2,10,1,8,1,0
24,96450,1956844,108,8,1905,3,female,1326.0,1233,506,163,180,143,111,20,69,0
25,71170,1959957,21,23,1992,12,male,804.0,190,160,0,6,0,3,0,3,1
26,23686,1848028,55,3,1958,10,male,784.0,30,16,2,28,0,16,2,12,1
27,86541,1725028,18,2,1995,6,male,925.0,366,170,37,102,18,64,19,38,1
28,25826,1880443,17,17,1996,9,male,317.0,32,3,6,0,6,0,0,0,0
29,65931,1597662,66,27,1947,7,female,234.0,145,41,89,1,0,0,89,1,0
30,8143,1701764,49,2,1964,5,male,263.0,6,4,2,13,1,12,1,1,1
31,59244,1379637,21,2,1992,11,male,225.0,116,46,0,0,0,0,0,0,0
32,68773,1876592,56,18,1957,3,male,714.0,163,100,39,49,39,30,0,19,0
33,68515,2039758,67,16,1946,5,female,1646.0,168,36,6,78,6,48,0,30,0
34,76214,1807838,21,1,1992,9,male,419.0,230,186,0,2,0,2,0,0,0
35,54043,1242957,60,4,1953,11,male,2051.0,97,20,72,162,1,76,71,86,1
36,17670,1009332,13,23,2000,2,female,298.0,21,10,0,1,0,1,0,0,1
37,89755,1525115,37,1,1976,7,male,803.0,460,403,188,163,176,88,12,75,1
38,88103,2189292,93,18,1920,5,male,829.0,392,292,2465,903,2465,738,0,165,0
39,48057,1137806,13,7,2000,3,male,174.0,77,71,70,0,6,0,64,0,1
40,3982,2053592,24,5,1989,6,male,830.0,2,1,0,2,0,1,0,1,0
41,25879,1892074,15,10,1998,11,male,176.0,33,26,8,4,0,0,8,4,1
42,5157,2185734,32,1,1981,12,male,192.0,3,3,0,0,0,0,0,0,1
43,80093,1575539,14,13,1999,5,male,369.0,269,205,0,1,0,0,0,1,1
44,15334,1370511,20,2,1993,8,male,281.0,17,10,29,3,29,3,0,0,0
45,75433,1498623,18,11,1995,4,female,143.0,215,92,8,10,6,2,2,8,1
46,71933,1415839,46,9,1967,3,male,437.0,190,129,151,14,151,1,0,13,1
47,78948,1334496,26,12,1987,2,female,457.0,243,159,330,229,256,76,74,153,0
48,85710,1834971,93,24,1920,5,male,819.0,350,259,93,25,93,19,0,6,1
49,45994,1769412,44,10,1969,3,male,406.0,72,72,64,17,61,12,3,5,0
50,85172,1416638,19,14,1994,7,male,303.0,338,160,1,0,0,0,1,0,0
51,43136,1789703,28,19,1985,12,male,54.0,66,52,49,15,49,13,0,2,0
52,39305,1056013,27,2,1986,2,male,239.0,59,50,0,0,0,0,0,0,1
53,59112,2014672,33,19,1980,9,female,440.0,114,84,480,422,480,411,0,11,1
54,18079,1596627,26,18,1987,4,male,253.0,21,4,5,1,5,1,0,0,0
55,2393,2076034,25,1,1988,1,male,245.0,1,1,0,0,0,0,0,0,0
56,36579,1977857,31,29,1982,8,female,306.0,53,40,0,0,0,0,0,0,1
57,29281,2144371,24,12,1989,6,male,218.0,37,19,65,1,65,0,0,1,1
58,17694,1853053,18,30,1995,1,male,263.0,21,19,0,0,0,0,0,0,1
59,30904,1822139,43,8,1970,1,male,162.0,41,23,27,8,1,2,26,6,0
60,92053,1610409,15,2,1998,8,female,228.0,625,575,0,0,0,0,0,0,0
61,53039,1544926,65,27,1948,4,male,593.0,92,72,186,180,137,79,49,101,1
62,98466,1959285,15,11,1998,6,female,655.0,3742,2009,347,3477,347,2723,0,754,1
63,29770,1834097,34,7,1979,9,male,340.0,39,33,6,2,0,1,6,1,0
64,69265,1869831,19,28,1994,6,male,487.0,173,137,0,0,0,0,0,0,1
65,79600,1237136,19,9,1994,8,male,739.0,251,194,36,19,36,13,0,6,1
66,78753,1791807,19,11,1994,1,male,301.0,247,89,84,85,71,46,13,39,0
67,31930,1168408,47,16,1966,5,male,420.0,42,9,11,0,11,0,0,0,0
68,73622,1187553,66,19,1947,1,male,558.0,200,159,36,4,33,1,3,3,1
69,30216,1854683,28,1,1985,3,male,618.0,41,16,0,0,0,0,0,0,1
70,50461,2114685,60,3,1953,9,female,925.0,86,36,0,0,0,0,0,0,1
71,82385,1462691,22,4,1991,3,female,837.0,291,58,8,0,8,0,0,0,0
72,56831,1684938,38,12,1975,3,female,408.0,105,64,32,25,32,21,0,4,1
73,90717,1735021,21,17,1992,8,female,689.0,491,273,160,364,160,258,0,106,1
74,41456,1146344,55,26,1958,8,male,1502.0,64,17,2,4,0,3,2,1,1
75,47180,1917727,53,18,1960,3,male,38.0,76,69,63,81,63,46,0,35,0
76,88899,1153649,23,12,1990,1,female,792.0,421,363,348,392,72,144,276,248,0
77,5559,1811574,37,31,1976,1,male,346.0,3,2,4,0,0,0,4,0,1
78,3849,1584595,18,29,1995,5,female,571.0,2,1,0,0,0,0,0,0,1
79,72986,1745741,56,23,1957,2,female,460.0,195,149,322,88,3,30,319,58,1
80,70132,1541667,48,12,1965,12,female,1452.0,171,126,1032,633,857,400,175,233,1
81,14715,1765637,48,29,1965,9,male,74.0,16,15,1,0,0,0,1,0,0
82,65514,1328121,28,14,1985,12,male,205.0,147,111,5,14,5,14,0,0,0
83,44617,2138402,36,6,1977,10,male,726.0,70,54,7,26,7,13,0,13,0
84,76858,1595281,15,18,1998,4,male,548.0,224,116,122,132,122,56,0,76,0
85,57243,1746802,28,29,1985,9,male,571.0,110,87,0,1,0,1,0,0,0
86,40820,1861483,33,16,1980,11,male,833.0,60,10,79,21,79,3,0,18,0
87,38547,1421934,19,11,1994,2,female,322.0,56,38,1,5,1,0,0,5,1
88,76629,2147313,44,27,1969,7,male,307.0,222,15,28,59,28,35,0,24,0
89,58380,1693115,26,31,1987,12,female,476.0,115,44,1,2,1,1,0,1,0
90,9009,1283905,17,14,1996,2,male,309.0,8,2,1,0,0,0,1,0,1
91,52494,1456553,26,1,1987,1,male,411.0,92,47,2,0,2,0,0,0,1
92,7576,1112130,28,1,1985,1,male,211.0,6,3,0,0,0,0,0,0,0
93,28310,1048383,14,14,1999,9,male,217.0,37,27,0,5,0,5,0,0,1
94,68520,1262011,61,1,1952,1,male,591.0,163,96,7,7,0,7,7,0,1
95,15321,1699746,56,26,1957,1,female,373.0,16,14,27,2,0,0,27,2,1
96,96013,1545563,17,4,1996,9,male,44.0,921,664,4415,2953,4303,2305,112,648,1
97,97733,1494452,26,29,1987,7,female,1063.0,1656,536,848,4223,250,3209,598,1014,1
98,58896,1419765,43,19,1970,8,female,765.0,115,59,72,15,72,8,0,7,1
99,92343,1583806,20,5,1993,9,male,880.0,618,267,25,514,25,453,0,61,0
100,96601,1711714,13,1,2000,1,female,390.0,1067,171,359,211,278,148,81,63,1
101,53645,1509101,34,16,1979,9,female,124.0,95,75,9,98,6,28,3,70,1
102,10310,1805083,31,6,1982,3,female,267.0,10,3,2,4,2,4,0,0,1
103,12009,1207979,22,22,1991,3,male,436.0,12,11,10,1,10,1,0,0,0
104,3359,1031925,49,27,1964,9,male,58.0,1,1,2,0,2,0,0,0,1
105,36148,1107685,25,21,1988,12,female,500.0,50,36,35,29,35,24,0,5,1
106,49772,1452025,26,8,1987,10,male,586.0,82,23,11,4,11,3,0,1,1
107,58513,1967895,19,12,1994,9,male,622.0,115,29,5,0,5,0,0,0,0
108,45819,1629962,75,26,1938,4,female,950.0,71,34,26,5,0,4,26,1,1
109,41936,1062351,58,20,1955,11,female,2254.0,62,28,24,34,24,6,0,28,1
110,14897,1647400,14,29,1999,7,female,266.0,17,14,2,1,2,0,0,1,0
111,91707,1998890,59,10,1954,4,female,1534.0,569,334,223,149,68,68,155,81,1
112,47166,1917279,107,27,1906,11,female,755.0,76,39,56,22,56,17,0,5,0
113,46750,1543951,18,22,1995,5,male,66.0,76,72,4,5,4,5,0,0,0
114,67836,1701410,36,27,1977,1,male,738.0,160,102,63,114,63,44,0,70,0
115,94881,1642058,18,24,1995,2,female,1462.0,807,540,901,271,319,177,582,94,1
116,26367,2006016,28,28,1985,5,female,254.0,32,13,142,65,142,26,0,39,1
117,34886,1005052,40,9,1973,11,male,246.0,48,35,4,90,4,44,0,46,1
118,16928,1224195,25,1,1988,1,male,438.0,19,14,2,4,2,3,0,1,0
119,50861,2053062,31,17,1982,9,female,277.0,87,60,21,55,21,38,0,17,1
120,85433,2020680,28,12,1985,7,male,527.0,345,310,15,12,15,8,0,4,1
121,33240,1163579,26,3,1987,1,female,356.0,45,25,59,54,59,10,0,44,0
122,75366,1547952,28,24,1985,5,male,1494.0,216,119,4,163,4,155,0,8,0
123,71229,1724060,31,23,1982,8,male,207.0,189,97,0,9,0,6,0,3,0
124,74356,1578921,103,28,1910,10,female,1717.0,211,60,4,139,1,77,3,62,0
125,93067,1159372,14,7,1999,2,male,168.0,655,537,0,0,0,0,0,0,1
126,9279,1053472,50,17,1963,7,male,68.0,8,8,15,8,11,2,4,6,1
127,28537,1284162,49,10,1964,7,male,495.0,37,20,0,0,0,0,0,0,0
128,43619,1143315,32,21,1981,5,male,315.0,67,20,1,20,1,6,0,14,1
129,12243,2096032,20,11,1993,1,female,100.0,13,8,0,0,0,0,0,0,1
130,49670,1750740,49,25,1964,5,male,418.0,83,75,5,0,5,0,0,0,1
131,66369,1856304,98,27,1915,10,male,374.0,151,135,0,0,0,0,0,0,0
132,89802,1849751,20,19,1993,12,female,701.0,460,350,245,131,153,72,92,59,0
133,44470,1192350,28,20,1985,10,male,56.0,70,53,2,0,2,0,0,0,0
134,83956,1494748,38,18,1975,7,female,663.0,307,170,409,528,403,412,6,116,1
135,79636,1362232,45,23,1968,7,female,654.0,260,170,44,20,1,9,43,11,0
136,57648,1976086,65,14,1948,2,male,782.0,110,67,13,8,13,6,0,2,0
137,49180,1086351,23,11,1990,1,male,324.0,79,53,286,180,233,71,53,109,0
138,43907,1966000,41,12,1972,2,male,229.0,67,60,27,9,11,9,16,0,1
139,75689,1263208,41,28,1972,3,male,223.0,220,73,41,4,41,3,0,1,1
140,65646,1070149,27,19,1986,11,male,337.0,147,45,16,1,16,0,0,1,1
141,29600,1474103,46,5,1967,8,male,350.0,39,33,0,0,0,0,0,0,1
142,812,1162568,27,24,1986,3,male,3.0,0,0,0,0,0,0,0,0,1
143,40382,2044507,35,16,1978,2,female,522.0,61,35,2,7,2,7,0,0,0
144,56877,1792329,20,1,1993,6,male,128.0,106,98,47,34,47,28,0,6,0
145,30259,1652137,36,1,1977,4,male,453.0,40,24,0,0,0,0,0,0,0
146,21123,1109775,27,10,1986,9,male,61.0,25,24,148,16,137,10,11,6,0
147,60696,2076124,71,17,1942,3,male,950.0,121,94,15,1,15,1,0,0,1
148,35313,1303356,19,24,1994,8,male,327.0,49,38,108,2,108,2,0,0,0
149,84626,1420348,27,11,1986,1,male,535.0,337,256,52,95,52,72,0,23,1
150,24122,1099770,49,6,1964,11,female,252.0,29,20,22,47,7,15,15,32,0
151,68492,1196519,43,25,1970,1,male,1235.0,163,38,6,0,0,0,6,0,0
152,11510,1060546,62,25,1951,2,female,402.0,11,10,585,342,585,98,0,244,0
153,78966,1962088,51,9,1962,8,female,225.0,250,195,374,120,4,33,370,87,1
154,57625,1841296,47,1,1966,1,male,475.0,110,74,10,42,10,34,0,8,1
155,2091,1303635,18,28,1995,3,male,552.0,1,1,0,0,0,0,0,0,1
156,56132,1702711,21,2,1992,5,female,591.0,104,82,154,303,56,168,98,135,0
157,81655,1899833,30,9,1983,7,male,1289.0,285,226,68,40,63,33,5,7,1
158,43192,1179379,19,24,1994,8,male,136.0,65,56,69,14,69,13,0,1,0
159,38274,1426490,18,29,1995,8,female,733.0,55,39,236,148,235,119,1,29,1
160,70043,1739744,100,3,1913,9,female,390.0,173,123,366,333,358,235,8,98,1
161,81929,1460578,14,31,1999,1,female,331.0,277,200,334,107,45,74,289,33,0
162,14556,1786304,40,5,1973,10,female,620.0,17,9,0,0,0,0,0,0,0
163,77411,1464416,19,21,1994,7,male,157.0,239,214,6,1,6,1,0,0,0
164,94189,1615686,18,27,1995,7,female,374.0,780,368,5,38,5,23,0,15,0
165,91339,1189903,18,20,1995,2,female,223.0,557,301,21,67,21,56,0,11,0
166,7501,1475345,26,16,1987,11,male,402.0,7,5,0,0,0,0,0,0,1
167,16404,1298178,24,6,1989,4,male,936.0,20,2,0,0,0,0,0,0,1
168,38333,1829450,41,26,1972,10,female,444.0,55,18,5615,5600,5615,3457,0,2143,1
169,68640,1838648,18,31,1995,5,male,157.0,168,97,16,3,4,1,12,2,1
170,59893,1145716,35,29,1978,4,female,746.0,116,76,47,163,9,65,38,98,1
171,19405,1933749,44,10,1969,3,female,70.0,23,16,19,2,19,0,0,2,1
172,32339,1073600,86,25,1927,5,female,1517.0,42,29,282,67,0,14,282,53,1
173,91251,1605943,108,10,1905,5,male,1092.0,525,436,7,19,0,0,7,19,0
174,66415,2039035,33,6,1980,11,male,576.0,153,146,1,5,1,5,0,0,0
175,87471,1619561,28,26,1985,2,male,394.0,395,315,26,74,0,26,26,48,1
176,24559,1439723,23,8,1990,8,male,360.0,31,31,0,0,0,0,0,0,0
177,38177,1691201,32,7,1981,4,male,775.0,55,23,81,71,77,44,4,27,1
178,8719,1747667,19,5,1994,11,male,20.0,8,7,0,0,0,0,0,0,1
179,11108,1536088,113,18,1900,11,female,1133.0,11,10,0,0,0,0,0,0,0
180,20860,1847753,15,14,1998,6,female,266.0,25,13,5,2,0,2,5,0,1
181,56567,1606972,73,24,1940,7,male,1104.0,106,63,2,8,2,8,0,0,0
182,91583,1253503,100,28,1913,12,male,1723.0,524,138,116,399,104,265,12,134,1
183,24365,1783785,26,1,1987,1,female,313.0,29,13,95,26,95,22,0,4,1
184,95987,1178301,16,27,1997,5,male,441.0,962,854,2408,395,2408,300,0,95,0
185,59243,2074091,21,13,1992,11,male,614.0,119,101,0,0,0,0,0,0,1
186,9852,2059439,44,17,1969,12,male,945.0,10,6,0,0,0,0,0,0,0
187,20108,1332182,21,3,1992,11,male,614.0,24,20,3,1,3,1,0,0,0
188,12452,1348822,32,11,1981,10,male,353.0,13,13,0,3,0,3,0,0,0
189,68423,1024219,21,2,1992,5,male,518.0,163,111,3,3,2,3,1,0,0
190,9329,1617466,32,24,1981,9,male,256.0,8,6,35,2,0,2,35,0,0
191,64889,1052792,61,22,1952,1,male,22.0,143,89,90,177,90,145,0,32,1
192,82872,1920811,42,26,1971,2,female,483.0,291,248,212,39,212,24,0,15,1
193,26935,2038159,56,22,1957,1,male,440.0,35,28,2,2,0,0,2,2,0
194,97890,1366254,16,14,1997,4,male,596.0,1347,814,2106,1457,1699,1024,407,433,1
195,77746,1938892,35,27,1978,11,male,261.0,235,72,71,39,23,6,48,33,1
196,49579,1074611,18,11,1995,1,female,314.0,84,45,2,17,2,7,0,10,1
197,34833,1908971,17,10,1996,10,male,291.0,48,20,3,0,3,0,0,0,1
198,14326,1650762,20,2,1993,8,male,75.0,17,16,0,1,0,1,0,0,0
199,29724,1548947,31,31,1982,3,male,299.0,39,24,3,55,3,38,0,17,1
200,50083,2117102,56,5,1957,1,male,339.0,83,62,88,36,40,30,48,6,0
201,73681,1759200,17,10,1996,5,male,553.0,201,155,49,3,0,0,49,3,0
202,42040,2053849,47,18,1966,5,male,1707.0,62,38,40,7,40,3,0,4,1
203,87409,1645110,19,10,1994,4,female,449.0,391,253,15,5,0,0,15,5,1
204,10878,2086425,21,6,1992,11,female,376.0,11,6,0,0,0,0,0,0,0
205,72719,2072130,20,6,1993,3,male,402.0,192,37,47,58,47,38,0,20,1
206,69917,1656998,58,12,1955,7,male,397.0,170,118,131,58,0,8,131,50,1
207,36530,2026264,23,14,1990,8,male,486.0,53,37,0,0,0,0,0,0,0
208,88805,2095778,16,23,1997,3,male,217.0,412,391,219,14,219,14,0,0,1
209,29943,1571579,72,22,1941,10,female,1543.0,39,26,49,38,0,9,49,29,0
210,42168,1348400,59,3,1954,6,female,654.0,62,34,71,20,71,19,0,1,0
211,43335,1187100,18,1,1995,6,male,15.0,65,58,379,371,264,206,115,165,0
212,85853,1431861,15,17,1998,8,male,313.0,338,139,206,132,206,126,0,6,1
213,44739,2028152,40,16,1973,8,male,303.0,70,34,20,85,20,7,0,78,0
214,50961,1933025,32,27,1981,9,male,528.0,85,36,41,154,41,137,0,17,0
215,95395,1433137,19,17,1994,2,male,406.0,994,730,86,129,51,90,35,39,1
216,91697,1682477,33,8,1980,1,female,155.0,573,258,215,209,206,162,9,47,1
217,56892,1554746,52,19,1961,12,male,272.0,105,64,50,62,50,45,0,17,1
218,60851,2076521,25,30,1988,10,male,14.0,124,123,52,6,52,6,0,0,0
219,5479,1729812,30,2,1983,4,female,131.0,3,2,2,0,0,0,2,0,1
220,45721,1352280,35,10,1978,10,female,506.0,73,31,15,3,0,0,15,3,0
221,47596,1166636,48,12,1965,3,male,717.0,78,57,0,0,0,0,0,0,1
222,7443,1895895,23,12,1990,12,male,136.0,7,3,0,0,0,0,0,0,1
223,56767,1967090,22,27,1991,12,male,1023.0,105,72,21,0,0,0,21,0,1
224,44024,1172482,23,1,1990,1,male,61.0,67,38,60,5,60,3,0,2,1
225,86408,1542083,27,27,1986,7,female,236.0,360,175,13,40,13,29,0,11,1
226,3979,1706937,24,26,1989,5,female,417.0,2,2,0,0,0,0,0,0,0
227,61419,1830444,13,27,2000,6,male,336.0,127,39,3,3,0,2,3,1,1
228,67918,1512365,48,12,1965,6,female,458.0,158,115,110,133,94,59,16,74,1
229,82236,1067887,17,9,1996,4,male,224.0,294,235,1,3,1,3,0,0,0
230,83380,1577618,21,31,1992,8,female,463.0,314,105,7,5,7,4,0,1,0
231,24751,1694380,15,11,1998,9,male,473.0,31,23,2,0,2,0,0,0,1
232,84950,2046760,48,27,1965,9,female,281.0,326,199,489,1199,63,448,426,751,1
233,93902,1467431,18,25,1995,11,female,99.0,691,292,742,490,742,469,0,21,1
234,27833,1047110,44,1,1969,8,male,485.0,36,19,1,0,0,0,1,0,0
235,84360,1563104,18,4,1995,1,female,337.0,332,126,6,56,6,51,0,5,1
236,7498,1451110,24,19,1989,9,male,427.0,7,0,0,0,0,0,0,0,1
237,67440,1211093,101,29,1912,7,female,722.0,161,69,2,0,2,0,0,0,1
238,2825,1393677,38,20,1975,4,male,122.0,1,1,0,0,0,0,0,0,0
239,69415,1380502,31,15,1982,8,male,208.0,172,112,2,2,2,2,0,0,0
240,59807,1983051,15,26,1998,6,female,236.0,119,81,27,9,27,9,0,0,1
241,46656,1384731,31,2,1982,4,male,293.0,74,26,2,0,2,0,0,0,0
242,17342,1032186,52,31,1961,12,male,321.0,19,15,18,12,18,12,0,0,1
243,98568,1551348,17,27,1996,2,female,447.0,2083,311,599,1372,598,1048,1,324,0
244,75698,1530313,27,13,1986,8,female,542.0,215,100,44,281,22,106,22,175,0
245,71235,1566014,35,26,1978,11,male,604.0,190,72,0,2,0,1,0,1,0
246,51129,1430791,44,15,1969,9,female,104.0,87,46,138,296,137,165,1,131,0
247,34357,1846324,25,31,1988,12,male,179.0,47,30,135,1,135,1,0,0,0
248,75355,1128463,20,5,1993,3,male,287.0,213,150,4,8,0,7,4,1,1
249,48836,1994526,27,6,1986,6,female,151.0,80,50,23,22,23,20,0,2,0
250,82691,1210197,25,9,1988,4,male,418.0,289,226,70,32,70,28,0,4,1
251,39688,1770774,28,28,1985,11,male,151.0,58,36,10,4,10,2,0,2,1
252,18040,1673846,18,22,1995,9,male,10.0,21,16,4,1,0,1,4,0,0
253,68944,1142830,68,29,1945,8,female,129.0,168,128,110,547,110,78,0,469,1
254,81870,1635225,28,18,1985,7,male,522.0,282,152,229,146,150,128,79,18,1
255,78027,1134553,23,12,1990,12,male,191.0,232,207,374,157,374,139,0,18,1
256,1738,1722049,21,1,1992,2,female,27.0,0,0,1,0,1,0,0,0,1
257,44919,1170583,32,13,1981,11,female,197.0,69,56,95,162,93,100,2,62,0
258,75719,1566316,33,5,1980,10,female,530.0,218,135,49,18,0,1,49,17,0
259,71562,2152574,23,26,1990,12,female,785.0,188,32,17,5,17,5,0,0,0
260,60539,1529971,48,20,1965,4,female,226.0,124,90,3,5,3,4,0,1,1
261,72460,1772723,32,1,1981,1,male,481.0,196,189,5,1,0,1,5,0,0
262,91937,1798781,16,13,1997,6,male,192.0,521,383,986,107,705,69,281,38,0
263,63747,1183153,16,29,1997,7,male,24.0,136,130,22,29,22,20,0,9,0
264,1470,1438824,47,31,1966,10,male,110.0,0,0,0,0,0,0,0,0,0
265,91670,2048322,17,24,1996,8,female,278.0,535,51,183,22,183,11,0,11,1
266,61321,1773432,105,30,1908,3,male,1494.0,129,69,1,1,0,0,1,1,1
267,7779,1187560,45,22,1968,11,male,864.0,7,7,0,1,0,0,0,1,1
268,7748,2088611,40,23,1973,7,male,233.0,6,4,0,0,0,0,0,0,0
269,19627,2135470,13,24,2000,5,male,76.0,23,16,89,67,86,23,3,44,1
270,1066,1879816,32,27,1981,7,male,643.0,0,0,0,0,0,0,0,0,0
271,5622,1744542,51,22,1962,1,male,208.0,3,2,9,2,0,2,9,0,0
272,97940,1425934,20,29,1993,8,male,393.0,1456,381,2551,3864,2219,1847,332,2017,1
273,6028,2129172,37,4,1976,1,female,351.0,4,2,0,0,0,0,0,0,0
274,83165,1820536,20,16,1993,3,male,479.0,304,161,0,2,0,1,0,1,0
275,98650,1144745,46,19,1967,1,male,1423.0,4615,702,840,1896,347,772,493,1124,1
276,46890,1270048,15,1,1998,12,male,106.0,75,61,11,40,11,37,0,3,1
277,817,1534182,27,22,1986,5,male,1024.0,0,0,0,0,0,0,0,0,1
278,25850,2192769,34,20,1979,9,male,522.0,32,23,7,2,0,0,7,2,0
279,73554,1713643,27,14,1986,12,male,1399.0,200,98,21,44,16,30,5,14,1
280,62743,1891585,24,10,1989,8,male,317.0,134,42,24,35,24,29,0,6,0
281,41380,2070305,25,1,1988,1,male,265.0,62,40,1,0,1,0,0,0,0
282,31614,1166422,30,3,1983,11,male,203.0,43,32,1,3,1,2,0,1,1
283,67706,1779575,18,2,1995,7,female,482.0,159,115,27,5,0,5,27,0,1
284,5919,1152578,25,3,1988,2,male,426.0,4,3,0,0,0,0,0,0,0
285,70101,1780962,25,4,1988,4,female,166.0,174,23,566,709,566,547,0,162,0
286,2297,1685509,23,9,1990,2,female,29.0,1,0,0,0,0,0,0,0,0
287,46603,1367590,33,12,1980,6,male,219.0,75,65,1,83,1,36,0,47,1
288,68763,1184794,19,16,1994,1,female,330.0,163,141,37,15,37,10,0,5,1
289,97089,1182730,68,29,1945,8,female,1268.0,1320,537,3,8,3,7,0,1,1
290,25332,1126605,31,7,1982,6,male,334.0,32,19,0,0,0,0,0,0,1
291,70182,1521904,18,21,1995,3,male,414.0,180,172,0,0,0,0,0,0,1
292,78429,1367229,23,3,1990,1,female,521.0,241,172,7,7,7,4,0,3,0
293,16083,1172947,53,19,1960,6,female,769.0,18,11,12,1,11,1,1,0,0
294,2309,1279955,23,13,1990,4,male,268.0,1,1,0,0,0,0,0,0,1
295,53391,2062828,24,3,1989,7,male,341.0,95,76,1,1,1,0,0,1,1
296,25939,1342584,22,24,1991,8,male,437.0,33,31,10,0,10,0,0,0,1
297,22830,2033174,15,31,1998,8,female,75.0,28,21,7,1,7,1,0,0,1
298,87614,1137006,15,12,1998,7,female,364.0,407,312,65,3,65,3,0,0,1
299,30937,1131586,64,30,1949,3,male,112.0,40,27,32,22,2,3,30,19,0
300,70457,1454980,31,16,1982,7,male,626.0,179,63,6,0,6,0,0,0,0
301,74180,1699012,26,2,1987,12,male,605.0,205,116,0,0,0,0,0,0,0
302,96486,1215639,22,26,1991,10,female,479.0,1095,78,200,92,200,75,0,17,0
303,49671,1714033,21,2,1992,2,male,628.0,83,19,5,3,5,0,0,3,1
304,79584,1095963,16,8,1997,2,male,75.0,257,238,33,4,19,3,14,1,0
305,45239,1439606,34,18,1979,5,male,554.0,71,52,0,0,0,0,0,0,1
306,70619,2083239,24,4,1989,2,female,503.0,178,91,19,12,19,10,0,2,1
307,6661,1380613,27,12,1986,6,male,182.0,5,3,0,0,0,0,0,0,1
308,32618,1858501,63,1,1950,1,male,203.0,44,26,0,1,0,0,0,1,1
309,62361,1167617,33,10,1980,12,male,599.0,134,55,1,1,0,1,1,0,0
310,89606,1833683,24,18,1989,11,female,1080.0,446,171,72,52,33,25,39,27,0
311,96991,1723999,22,5,1991,12,female,529.0,1014,380,4900,2280,4849,1657,51,623,1
312,31899,1128015,45,30,1968,9,female,143.0,43,36,9,14,9,12,0,2,0
313,93227,1559499,16,8,1997,6,female,217.0,657,55,7,7,7,5,0,2,0
314,15511,1233889,103,31,1910,12,male,230.0,17,15,134,11,134,11,0,0,0
315,84024,1111923,46,10,1967,1,male,172.0,313,53,593,361,542,201,51,160,1
316,76169,1375046,15,26,1998,3,male,102.0,225,85,0,0,0,0,0,0,0
317,21724,1950694,61,15,1952,11,male,1417.0,26,9,2,4,1,3,1,1,1
318,45475,1248709,19,18,1994,10,male,176.0,73,72,3,0,3,0,0,0,0
319,35291,1638221,38,23,1975,2,male,519.0,48,11,86,38,86,22,0,16,0
320,16424,1100467,25,18,1988,6,female,437.0,19,6,0,0,0,0,0,0,0
321,72017,1546280,30,15,1983,3,female,306.0,183,132,284,379,284,234,0,145,0
322,19506,1652054,20,19,1993,9,male,510.0,22,13,33,2,2,0,31,2,1
323,14446,1154900,28,11,1985,8,male,259.0,17,14,0,0,0,0,0,0,1
324,15520,1064820,57,22,1956,3,male,89.0,17,12,157,3,37,1,120,2,0
325,68439,1264221,37,30,1976,4,female,726.0,165,53,3,27,3,7,0,20,1
326,24496,2152603,52,12,1961,6,female,392.0,30,23,1486,554,1486,173,0,381,0
327,94000,1654785,48,3,1965,1,female,300.0,699,599,1866,1425,448,964,1418,461,1
328,27353,1378198,38,15,1975,4,female,584.0,34,18,21,58,21,58,0,0,1
329,22536,2190850,27,26,1986,8,male,209.0,28,22,0,0,0,0,0,0,0
330,288,1957627,19,6,1994,7,female,157.0,0,0,0,0,0,0,0,0,1
331,69197,2069375,65,21,1948,9,female,1420.0,167,83,1284,160,0,37,1284,123,0
332,54600,1649682,17,1,1996,1,male,191.0,98,63,3,3,3,3,0,0,0
333,52746,1763944,44,23,1969,9,male,292.0,92,59,20,28,20,3,0,25,1
334,98584,1349381,85,21,1928,5,male,1082.0,1954,1185,610,663,580,580,30,83,1
335,36234,1587493,37,27,1976,11,female,296.0,51,12,62,69,62,61,0,8,1
336,38011,1293610,73,11,1940,1,female,675.0,54,41,27,2,27,2,0,0,1
337,88320,1891710,18,13,1995,1,female,418.0,435,219,6,13,6,12,0,1,1
338,11135,1181335,38,28,1975,8,female,264.0,11,9,1,2,0,0,1,2,0
339,70573,1003315,24,15,1989,7,male,245.0,177,103,14,45,12,26,2,19,1
340,7907,1382196,62,5,1951,6,female,601.0,7,2,0,0,0,0,0,0,1
341,96304,1769750,22,10,1991,7,male,851.0,1030,813,46,40,46,39,0,1,1
342,60950,2144893,32,1,1981,1,male,302.0,122,109,113,18,113,8,0,10,0
343,78208,1372811,24,13,1989,1,male,636.0,245,125,0,3,0,3,0,0,0
344,77032,1162221,61,19,1952,1,female,283.0,230,31,463,520,461,171,2,349,0
345,62359,1569907,42,15,1971,8,male,280.0,130,108,1,0,0,0,1,0,1
346,84730,1004880,32,28,1981,9,female,228.0,323,268,98,148,72,56,26,92,0
347,90507,1547651,14,1,1999,12,male,225.0,488,310,57,46,16,30,41,16,0
348,55681,2098349,21,15,1992,9,female,458.0,102,29,8,0,4,0,4,0,0
349,86167,1496889,23,1,1990,1,male,794.0,363,273,0,13,0,8,0,5,1
350,80402,1537486,18,14,1995,12,female,428.0,262,89,9,0,9,0,0,0,0
351,30277,1399782,42,24,1971,4,male,925.0,41,11,0,0,0,0,0,0,0
352,62407,1497689,26,21,1987,1,male,1094.0,133,47,1,5,1,5,0,0,0
353,52687,2095150,25,1,1988,1,male,115.0,93,68,11,0,7,0,4,0,1
354,49317,1915939,19,9,1994,5,male,105.0,82,74,0,2,0,1,0,1,0
355,67582,2030903,30,18,1983,8,male,462.0,160,58,10,29,3,20,7,9,1
356,6243,1153521,49,30,1964,8,male,96.0,4,4,1,0,1,0,0,0,0
357,5588,1079402,43,8,1970,8,male,37.0,3,3,5,0,2,0,3,0,1
358,44486,1730442,26,12,1987,4,male,356.0,70,47,2,18,2,13,0,5,1
359,74739,1181643,32,22,1981,4,male,171.0,207,190,65,47,65,41,0,6,1
360,73367,1893576,23,26,1990,5,male,411.0,203,144,4,0,4,0,0,0,0
361,19614,2075323,67,28,1946,6,male,751.0,22,4,82,51,0,11,82,40,1
362,37413,2109921,55,9,1958,10,female,409.0,53,24,1546,220,1546,151,0,69,1
363,68747,1583210,41,23,1972,9,male,544.0,163,134,34,81,34,64,0,17,0
364,53869,1079203,25,29,1988,3,male,699.0,97,42,28,28,7,14,21,14,0
365,76340,1998715,15,5,1998,5,female,286.0,228,30,2,15,2,8,0,7,1
366,27542,2006422,64,28,1949,6,female,89.0,34,12,85,49,29,31,56,18,1
367,49236,1374312,63,1,1950,12,female,310.0,79,31,557,199,0,35,557,164,0
368,12947,1267352,68,7,1945,6,female,1005.0,14,5,3,5,0,3,3,2,1
369,64126,1797477,27,14,1986,4,male,279.0,139,115,378,117,378,50,0,67,1
370,27320,1995158,70,9,1943,12,female,1590.0,35,23,18,13,0,8,18,5,1
371,82532,2045090,51,22,1962,8,female,1961.0,293,101,28,17,27,11,1,6,1
372,81460,1287106,23,28,1990,10,male,257.0,284,123,19,45,16,26,3,19,0
373,59523,1696190,22,16,1991,9,male,304.0,116,72,4,11,0,4,4,7,0
374,56027,2086236,28,6,1985,11,male,291.0,101,74,76,43,54,25,22,18,0
375,96460,1042427,103,14,1910,5,male,986.0,1191,760,172,62,172,56,0,6,1
376,8631,1003472,52,17,1961,7,male,124.0,6,2,85,40,66,22,19,18,0
377,64489,1743328,25,11,1988,12,male,211.0,144,133,3,3,3,3,0,0,1
378,62243,1239180,19,9,1994,5,male,822.0,130,70,0,8,0,8,0,0,1
379,89296,1903280,22,19,1991,11,male,973.0,456,305,5,0,0,0,5,0,0
380,12186,1711656,15,8,1998,1,male,118.0,13,13,0,2,0,1,0,1,0
381,28185,1609214,36,21,1977,6,female,213.0,36,30,64,19,57,8,7,11,1
382,65429,1138378,59,2,1954,10,male,989.0,147,36,2,15,2,15,0,0,0
383,94730,1311748,103,23,1910,7,female,936.0,764,333,340,590,340,372,0,218,1
384,12382,1800210,26,18,1987,8,male,147.0,13,11,0,0,0,0,0,0,0
385,83658,2181574,17,28,1996,6,female,276.0,307,239,68,320,68,281,0,39,1
386,20035,1810395,33,12,1980,10,male,315.0,24,20,1,4,1,4,0,0,1
387,19864,1588567,31,12,1982,5,male,67.0,24,13,0,0,0,0,0,0,1
388,84798,1999146,26,14,1987,7,female,339.0,330,197,167,79,167,66,0,13,1
389,17700,1851859,18,9,1995,2,male,32.0,21,6,0,0,0,0,0,0,0
390,23893,2047902,61,4,1952,6,female,681.0,30,26,7,3,6,1,1,2,0
391,27044,1812605,61,15,1952,8,male,1232.0,35,13,3,15,3,9,0,6,0
392,71996,1141479,58,2,1955,9,female,1352.0,183,57,255,199,240,144,15,55,0
393,92400,2057235,18,15,1995,6,female,595.0,626,480,37,34,37,29,0,5,1
394,86805,1897976,27,3,1986,2,female,214.0,366,272,189,250,189,208,0,42,1
395,5895,2188824,24,1,1989,1,male,469.0,4,3,0,0,0,0,0,0,1
396,34042,1068310,47,18,1966,11,female,642.0,47,32,12,29,12,13,0,16,1
397,79656,1334909,29,27,1984,8,female,322.0,255,30,48,114,34,82,14,32,1
398,61213,2003734,22,11,1991,6,male,296.0,126,104,0,2,0,2,0,0,0
399,38727,1219254,36,23,1977,1,male,307.0,56,22,7,22,4,7,3,15,1
400,62792,1457506,20,18,1993,12,female,646.0,130,52,36,37,36,31,0,6,1
401,48316,1533986,24,15,1989,6,male,510.0,79,33,0,4,0,2,0,2,1
402,85628,1676176,35,3,1978,4,female,147.0,338,298,60,80,56,57,4,23,0
403,7315,1701600,16,19,1997,11,male,132.0,7,6,0,0,0,0,0,0,1
404,61178,1483975,18,25,1995,4,male,819.0,128,67,0,0,0,0,0,0,0
405,80797,1844543,17,9,1996,10,male,379.0,266,141,103,118,103,87,0,31,1
406,71286,1616622,25,2,1988,2,male,187.0,189,121,1,0,1,0,0,0,1
407,83081,1793353,43,10,1970,4,female,571.0,289,197,1157,626,1152,420,5,206,0
408,91977,1971740,20,22,1993,4,female,862.0,522,303,1276,1463,1233,822,43,641,0
409,34791,1093534,25,1,1988,1,male,199.0,49,40,2,0,2,0,0,0,1
410,24902,2082509,44,9,1969,3,female,384.0,31,16,11,35,11,17,0,18,1
411,14872,1023463,59,4,1954,8,male,635.0,17,1,2,17,1,7,1,10,0
412,13198,1778350,58,21,1955,5,male,88.0,14,5,11,0,11,0,0,0,0
413,93785,2121194,29,29,1984,2,female,776.0,660,409,405,365,405,179,0,186,1
414,14007,1263951,21,10,1992,3,male,43.0,15,13,5,0,5,0,0,0,1
415,65486,1747312,18,23,1995,10,male,262.0,145,102,4,45,4,35,0,10,0
416,31702,1636444,55,5,1958,9,female,1625.0,43,25,3,9,0,2,3,7,0
417,48451,1931761,32,21,1981,12,male,347.0,80,62,1,0,1,0,0,0,1
418,90595,1347830,18,20,1995,7,female,261.0,503,325,93,199,93,153,0,46,0
419,64593,2003047,39,27,1974,8,male,575.0,141,53,9,38,9,25,0,13,0
420,78225,1378086,28,29,1985,7,male,534.0,247,172,0,0,0,0,0,0,0
421,74186,2085236,27,10,1986,12,male,932.0,210,179,0,1,0,1,0,0,1
422,9663,1263108,27,27,1986,4,male,211.0,10,4,0,0,0,0,0,0,1
423,2237,1277791,22,7,1991,1,male,317.0,1,1,0,0,0,0,0,0,1
424,57799,1606825,46,24,1967,10,female,431.0,110,51,39,28,0,14,39,14,1
425,68895,1817961,15,3,1998,2,female,672.0,164,68,80,108,76,94,4,14,0
426,38616,1167869,42,1,1971,1,male,539.0,57,46,3,0,0,0,3,0,1
427,60841,1175323,61,11,1952,9,male,819.0,124,84,50,23,32,11,18,12,1
428,63829,2011179,13,6,2000,2,male,78.0,135,112,42,32,29,17,13,15,0
429,3839,1043448,18,14,1995,1,female,143.0,2,0,0,0,0,0,0,0,1
430,57244,1064412,29,10,1984,4,male,482.0,108,83,0,3,0,3,0,0,0
431,52395,1198963,71,5,1942,12,male,1066.0,92,67,0,0,0,0,0,0,0
432,53916,1706048,30,3,1983,9,female,326.0,95,64,35,25,13,9,22,16,0
433,59924,2039326,33,29,1980,9,female,495.0,118,92,58,40,56,28,2,12,1
434,42554,1518809,27,1,1986,8,male,813.0,66,53,0,3,0,2,0,1,1
435,47833,1798350,29,1,1984,7,male,519.0,77,67,9,3,0,2,9,1,1
436,30753,1072840,31,2,1982,7,male,604.0,41,28,10,5,10,5,0,0,0
437,28790,1713336,56,9,1957,3,female,470.0,37,19,3,204,0,38,3,166,0
438,21619,1285385,20,12,1993,1,male,567.0,26,12,1,0,1,0,0,0,1
439,14725,1332295,23,20,1990,7,male,166.0,17,14,1,1,0,0,1,1,0
440,37977,1994357,68,17,1945,8,female,1031.0,54,37,22,2,18,2,4,0,1
441,61503,2095470,20,25,1993,11,female,240.0,126,37,5,7,5,5,0,2,0
442,42997,2042440,57,31,1956,12,female,926.0,65,26,19,13,3,5,16,8,0
443,12637,1576643,65,1,1948,5,male,402.0,14,8,0,0,0,0,0,0,0
444,94852,1167374,18,16,1995,8,male,426.0,831,587,698,1908,698,1499,0,409,1
445,39755,1639383,24,15,1989,10,male,305.0,59,49,16,0,16,0,0,0,1
446,5377,2021256,67,15,1946,8,female,285.0,3,1,0,0,0,0,0,0,1
447,62379,1124134,24,1,1989,10,male,410.0,133,113,1,0,1,0,0,0,0
448,60012,1717082,24,16,1989,11,male,268.0,118,92,100,0,93,0,7,0,1
449,16396,2191015,23,2,1990,5,male,469.0,20,3,0,0,0,0,0,0,0
450,49972,1507246,19,24,1994,12,female,427.0,84,57,41,13,31,4,10,9,1
451,62549,1946927,38,27,1975,5,female,317.0,131,116,6,65,5,40,1,25,0
452,55667,1641335,16,5,1997,7,female,284.0,102,88,7,10,7,3,0,7,0
453,34506,1648920,18,4,1995,10,female,557.0,49,33,0,0,0,0,0,0,1
454,67791,1164703,19,1,1994,12,male,380.0,158,116,49,18,48,14,1,4,0
455,26126,1779161,36,18,1977,11,male,518.0,33,19,27,7,0,5,27,2,0
456,95359,1778597,19,26,1994,7,female,1056.0,851,724,61,231,61,207,0,24,1
457,54917,1069935,13,12,2000,1,male,11.0,99,61,37,110,10,28,27,82,1
458,89049,2033738,38,1,1975,8,female,2373.0,432,312,1217,889,473,352,744,537,1
459,92775,1262454,18,5,1995,8,female,635.0,637,333,346,298,346,189,0,109,1
460,57975,1131947,30,16,1983,10,male,604.0,111,64,105,9,105,5,0,4,0
461,18158,2078301,30,13,1983,5,male,60.0,21,17,13,2,13,1,0,1,0
462,59649,1758312,74,22,1939,6,female,1606.0,120,29,9,43,8,11,1,32,0
463,86062,1219965,19,27,1994,9,female,28.0,347,321,1211,816,667,404,544,412,0
464,96106,1705254,19,1,1994,1,male,750.0,1036,417,3,4,1,4,2,0,0
465,81413,1271665,17,30,1996,12,female,167.0,283,237,12,26,4,18,8,8,1
466,25860,1209209,14,10,1999,7,male,474.0,32,21,7,3,7,1,0,2,0
467,96893,1329711,15,2,1998,6,female,556.0,1179,1001,1760,1215,962,429,798,786,0
468,41044,2115880,15,17,1998,6,male,123.0,62,31,0,5,0,1,0,4,0
469,4600,1160115,57,15,1956,9,male,655.0,2,2,2,1,0,1,2,0,1
470,77299,1201238,21,23,1992,3,female,127.0,232,24,1,2,1,0,0,2,1
471,40196,1789300,28,2,1985,12,male,376.0,60,50,0,0,0,0,0,0,1
472,59161,1531024,48,24,1965,11,female,298.0,115,76,1172,579,390,219,782,360,1
473,86427,1305929,19,30,1994,5,male,548.0,374,313,16,34,0,10,16,24,1
474,97899,1360176,68,22,1945,12,female,480.0,1342,977,2002,2702,2000,2043,2,659,1
475,91140,1565024,15,6,1998,6,male,644.0,537,417,1,0,1,0,0,0,0
476,41937,1057593,20,11,1993,3,female,120.0,62,52,24,38,24,33,0,5,0
477,55094,1818425,31,16,1982,11,male,339.0,98,87,150,30,150,7,0,23,1
478,95740,1212608,16,26,1997,4,female,465.0,970,750,528,1119,528,391,0,728,0
479,49494,1514759,22,9,1991,4,male,480.0,82,75,1,0,1,0,0,0,0
480,70357,2024901,19,8,1994,8,male,677.0,179,149,2,2,2,0,0,2,1
481,63223,1340955,43,29,1970,5,female,113.0,130,95,1788,168,1788,96,0,72,0
482,84063,1788668,19,12,1994,11,female,249.0,311,143,964,1260,954,994,10,266,0
483,78183,1416411,20,1,1993,6,male,800.0,245,171,0,0,0,0,0,0,1
484,64549,1907451,22,20,1991,6,male,495.0,142,100,6,36,6,34,0,2,1
485,27240,2047279,30,21,1983,7,male,612.0,34,31,11,1,2,0,9,1,0
486,98661,1812241,103,10,1910,2,female,1981.0,2505,1125,818,857,818,775,0,82,0
487,55706,1629569,18,24,1995,9,male,217.0,104,34,9,5,9,2,0,3,0
488,24735,1401837,54,4,1959,3,male,306.0,31,28,1,28,1,19,0,9,0
489,6898,2104021,74,16,1939,4,male,87.0,5,4,0,1,0,1,0,0,0
490,27868,1965497,103,15,1910,2,male,1476.0,36,11,1,1,1,1,0,0,1
491,85960,1857221,21,11,1992,10,female,210.0,345,224,482,536,134,323,348,213,1
492,2412,1786605,25,1,1988,1,male,9.0,1,0,0,0,0,0,0,0,0
493,71709,1200260,14,27,1999,9,female,171.0,189,64,41,69,41,65,0,4,1
494,17269,1375246,21,10,1992,6,male,406.0,20,15,12,3,12,0,0,3,0
495,60925,1941751,55,1,1958,5,female,278.0,123,113,91,66,74,34,17,32,0
496,86590,1888226,23,28,1990,2,female,744.0,366,265,56,52,26,14,30,38,1
497,23932,1837358,56,4,1957,6,male,950.0,29,6,9,0,0,0,9,0,1
498,14083,1846890,40,12,1973,3,male,879.0,15,13,13,2,13,2,0,0,1
499,41707,1014503,22,10,1991,1,female,622.0,63,43,8,3,4,2,4,1,0
500,9471,1338523,18,18,1995,5,male,220.0,10,5,0,0,0,0,0,0,0
501,48470,1009728,19,20,1994,6,male,367.0,81,53,1,4,1,4,0,0,1
502,38577,1663038,55,19,1958,11,male,342.0,56,46,2,7,0,5,2,2,1
503,2817,1753806,39,27,1974,11,male,409.0,1,0,0,0,0,0,0,0,0
504,90529,1317613,30,13,1983,7,male,625.0,477,357,64,50,62,25,2,25,0
505,68072,1554685,35,10,1978,2,male,224.0,160,139,332,215,332,195,0,20,0
506,31998,1739520,51,27,1962,1,male,463.0,42,24,18,10,11,8,7,2,0
507,26631,1571806,32,5,1981,8,male,882.0,34,24,0,3,0,1,0,2,0
508,4900,2023474,15,16,1998,12,male,60.0,3,1,0,0,0,0,0,0,0
509,20198,1364938,25,12,1988,1,female,423.0,24,14,6,18,6,18,0,0,0
510,89234,1070484,18,2,1995,4,female,874.0,442,67,2,7,1,4,1,3,1
511,27864,1981801,32,7,1981,6,male,505.0,36,21,1,1,1,1,0,0,0
512,80672,1954913,108,12,1905,8,male,1403.0,264,74,49,14,49,10,0,4,0
513,75312,2180622,22,29,1991,7,female,680.0,216,128,2,4,2,4,0,0,1
514,13566,1076343,23,3,1990,2,male,1100.0,14,8,3743,123,2673,48,1070,75,1
515,32009,1488888,55,9,1958,9,male,573.0,43,19,18,31,18,13,0,18,1
516,31734,1235054,45,14,1968,8,male,710.0,42,18,3,3,3,2,0,1,0
517,19553,1008891,55,28,1958,11,female,509.0,22,15,43,17,43,13,0,4,1
518,46563,1305309,44,29,1969,3,male,173.0,75,71,1,0,1,0,0,0,1
519,87488,1095095,23,3,1990,3,male,592.0,391,292,30,16,17,10,13,6,1
520,55822,1495548,21,4,1992,7,female,232.0,102,70,21,2,21,1,0,1,0
521,1268,1179384,38,29,1975,5,male,219.0,0,0,0,0,0,0,0,0,1
522,86473,2038588,43,19,1970,6,male,532.0,365,133,23,31,4,29,19,2,0
523,79031,1061681,20,14,1993,8,female,584.0,244,105,799,398,181,136,618,262,1
524,94426,2017714,17,22,1996,5,female,326.0,758,526,61,122,61,23,0,99,0
525,66015,1985089,66,30,1947,6,female,1500.0,150,82,156,120,155,64,1,56,1
526,90961,1991240,58,4,1955,5,female,844.0,485,191,884,600,615,341,269,259,0
527,4063,1927602,27,14,1986,9,female,409.0,2,1,0,0,0,0,0,0,1
528,66006,1910322,29,20,1984,6,male,325.0,145,133,142,234,142,233,0,1,0
529,65540,1502360,21,9,1992,10,male,154.0,146,112,7,2,7,2,0,0,0
530,53635,1775719,25,24,1988,8,male,999.0,95,68,8,9,8,4,0,5,0
531,57870,1095403,19,31,1994,8,male,249.0,111,88,56,35,48,30,8,5,0
532,55320,2068007,25,8,1988,6,male,1039.0,101,41,0,0,0,0,0,0,0
533,72115,1469582,19,9,1994,4,female,232.0,190,142,751,460,728,360,23,100,1
534,82276,1721081,20,30,1993,8,male,730.0,293,168,2,29,2,13,0,16,0
535,91168,1498980,108,22,1905,10,male,1157.0,525,142,1,3,1,3,0,0,0
536,94634,1724877,15,29,1998,8,male,344.0,771,391,208,31,208,22,0,9,1
537,70053,1169950,50,11,1963,1,female,237.0,173,108,392,279,389,200,3,79,0
538,38546,1412375,18,3,1995,10,female,447.0,56,22,1,23,1,23,0,0,0
539,14264,1188875,16,12,1997,4,female,480.0,16,14,0,0,0,0,0,0,0
540,4121,1228976,32,14,1981,12,male,879.0,2,2,0,0,0,0,0,0,0
541,69878,1915533,47,10,1966,10,female,909.0,170,88,93,36,85,22,8,14,1
542,25457,2104179,66,11,1947,2,male,285.0,32,8,0,0,0,0,0,0,1
543,9312,2149914,30,24,1983,9,female,219.0,8,4,27,4,27,2,0,2,0
544,11762,1190599,65,28,1948,12,male,703.0,12,3,0,4,0,4,0,0,1
545,41591,1061025,24,9,1989,1,female,370.0,63,40,4,0,4,0,0,0,1
546,37034,1401959,64,16,1949,5,male,734.0,53,33,15,10,13,7,2,3,1
547,70052,2018142,36,15,1977,11,female,914.0,175,125,377,98,374,63,3,35,0
548,72090,1086836,55,29,1958,1,female,1544.0,186,159,586,345,586,237,0,108,0
549,93170,1090343,20,29,1993,7,male,835.0,652,360,2,5,2,3,0,2,1
550,37587,1781641,78,20,1935,3,male,1819.0,54,16,0,0,0,0,0,0,1
551,49718,2008202,19,21,1994,4,female,13.0,84,53,7,82,7,50,0,32,1
552,61970,1559947,18,24,1995,10,male,368.0,126,65,123,156,20,76,103,80,0
553,23027,1971449,22,21,1991,8,male,6.0,28,11,52,11,52,11,0,0,1
554,24173,1389007,60,22,1953,3,female,13.0,30,24,28,54,28,38,0,16,0
555,74819,2126467,13,14,2000,1,female,530.0,206,183,118,13,4,4,114,9,1
556,68428,2071334,20,19,1993,12,male,680.0,169,49,3,0,3,0,0,0,1
557,60800,1836021,20,13,1993,10,female,36.0,124,123,37,1,37,1,0,0,0
558,33662,1516602,73,8,1940,4,male,1095.0,47,16,0,7,0,7,0,0,1
559,60006,1103622,37,7,1976,4,male,506.0,118,45,98,39,98,38,0,1,0
560,27379,1449827,49,16,1964,7,female,889.0,34,13,27,12,27,12,0,0,1
561,53005,1257588,35,25,1978,9,female,412.0,93,50,141,142,141,87,0,55,0
562,89478,1314102,103,15,1910,6,male,1510.0,465,202,34,24,30,15,4,9,0
563,22127,1864678,28,11,1985,7,female,9.0,26,25,18,7,0,0,18,7,1
564,83030,1369079,65,18,1948,10,female,627.0,299,146,634,677,634,265,0,412,0
565,56197,1244067,27,6,1986,9,female,457.0,102,71,238,116,238,54,0,62,0
566,22315,2045676,44,18,1969,4,male,71.0,26,23,67,57,67,51,0,6,1
567,37729,2156861,25,3,1988,11,male,128.0,54,24,3,26,3,18,0,8,1
568,78113,1282469,14,23,1999,1,female,273.0,237,152,899,104,899,90,0,14,1
569,19175,2172620,48,25,1965,3,male,677.0,22,15,6,2,6,2,0,0,1
570,64065,1966352,19,15,1994,9,male,5.0,136,124,215,37,215,27,0,10,1
571,11214,1165817,33,17,1980,2,male,29.0,11,10,2,1,2,1,0,0,1
572,15588,1448863,16,16,1997,3,male,181.0,18,17,0,0,0,0,0,0,1
573,44997,1409968,67,9,1946,10,female,540.0,70,22,225,51,0,31,225,20,1
574,55404,1595991,68,13,1945,5,male,1232.0,102,33,0,5,0,5,0,0,0
575,86374,1117604,20,27,1993,10,female,410.0,380,191,10,17,1,15,9,2,1
576,83736,1744728,20,20,1993,8,male,353.0,318,249,111,169,96,75,15,94,0
577,39788,1696436,52,21,1961,3,female,474.0,58,35,21,10,21,9,0,1,0
578,97488,1564821,16,19,1997,3,female,482.0,1818,289,241,402,240,267,1,135,1
579,21211,1973829,18,26,1995,9,male,597.0,26,11,0,2,0,2,0,0,1
580,81003,2102891,14,4,1999,5,female,13.0,262,126,539,238,16,128,523,110,1
581,28783,1803188,53,1,1960,12,male,882.0,38,17,3,1,0,0,3,1,0
582,3975,1078044,24,6,1989,3,male,395.0,2,2,0,0,0,0,0,0,1
583,29550,1529628,27,10,1986,8,male,544.0,39,4,0,0,0,0,0,0,1
584,25434,1468909,60,3,1953,5,male,559.0,32,22,0,0,0,0,0,0,0
585,12910,1834492,57,17,1956,2,female,70.0,14,12,2,1,2,0,0,1,0
586,51425,1827211,72,16,1941,11,female,933.0,88,55,0,0,0,0,0,0,1
587,5655,2074521,38,4,1975,5,male,160.0,3,1,14,0,14,0,0,0,0
588,20581,1092882,26,1,1987,1,male,197.0,25,20,0,0,0,0,0,0,0
589,68327,1661873,19,31,1994,12,male,375.0,167,93,1,0,0,0,1,0,1
590,2477,1871315,26,10,1987,9,female,356.0,1,0,0,0,0,0,0,0,0
591,32288,2046135,47,25,1966,12,female,509.0,43,27,149,1,0,0,149,1,0
592,75481,1358970,18,27,1995,3,male,223.0,221,119,11,23,11,21,0,2,1
593,57426,2097394,37,24,1976,4,male,558.0,110,48,2,2,2,1,0,1,0
594,28744,1676958,51,13,1962,5,male,332.0,37,28,2,0,2,0,0,0,0
595,41554,1208668,15,31,1998,1,male,357.0,63,40,3,1,3,1,0,0,1
596,20367,1768716,22,18,1991,7,female,82.0,24,19,34,12,21,11,13,1,1
597,89685,1659296,20,8,1993,1,female,638.0,458,334,127,34,127,26,0,8,0
598,63290,2142710,24,13,1989,12,female,36.0,135,134,0,0,0,0,0,0,0
599,73320,1478715,24,12,1989,8,male,256.0,201,187,2,2,2,1,0,1,0
600,65443,1657618,23,9,1990,12,female,564.0,145,78,3,0,3,0,0,0,0
601,20944,2100048,23,10,1990,1,male,289.0,25,23,13,6,13,6,0,0,0
602,22605,1227875,53,25,1960,7,male,1083.0,28,4,0,3,0,3,0,0,1
603,77591,1759326,35,18,1978,9,male,1612.0,235,167,27,10,27,4,0,6,1
604,55865,1270520,27,24,1986,1,male,340.0,103,76,26,29,26,15,0,14,1
605,30800,1270064,39,8,1974,7,female,456.0,40,16,14,4,14,0,0,4,0
606,50243,1389160,58,17,1955,2,female,1362.0,82,45,470,93,470,44,0,49,0
607,36456,1224594,14,9,1999,10,male,213.0,53,41,0,0,0,0,0,0,1
608,42061,1118242,23,3,1990,2,male,265.0,62,33,44,73,44,67,0,6,1
609,22762,1980261,35,11,1978,7,male,18.0,28,15,3,1,3,0,0,1,1
610,73519,1249380,22,19,1991,9,female,513.0,202,174,16,1,16,1,0,0,1
611,45142,1429910,21,6,1992,8,male,359.0,72,50,0,0,0,0,0,0,0
612,46096,1009154,50,31,1963,1,male,442.0,72,15,136,80,0,27,136,53,1
613,93026,1512796,13,13,2000,2,female,845.0,582,369,2178,990,2145,796,33,194,0
614,95071,1634658,23,14,1990,2,male,661.0,845,495,0,0,0,0,0,0,0
615,2437,1270007,25,8,1988,8,male,419.0,1,0,0,0,0,0,0,0,0
616,73608,1000549,30,17,1983,9,male,676.0,199,47,31,12,31,9,0,3,0
617,12029,1187958,52,11,1961,2,female,579.0,12,8,14,4,13,4,1,0,0
618,82736,1486493,21,3,1992,7,female,641.0,295,170,90,53,90,49,0,4,0
619,88260,2190853,18,20,1995,12,male,515.0,434,312,3,0,3,0,0,0,1
620,68541,1921344,34,8,1979,1,male,1506.0,169,164,8,3,8,3,0,0,1
621,79906,2163465,31,29,1982,3,male,333.0,255,184,288,103,288,60,0,43,0
622,24152,1127910,31,11,1982,3,female,279.0,30,18,26,5,25,1,1,4,1
623,89829,1453275,22,18,1991,5,female,809.0,445,383,277,206,277,159,0,47,1
624,51381,1374939,29,1,1984,1,male,298.0,88,67,0,4,0,2,0,2,1
625,60450,1840713,21,3,1992,3,male,430.0,121,100,1,68,1,49,0,19,0
626,42183,1273340,33,1,1980,4,male,362.0,62,32,75,49,74,26,1,23,0
627,51528,1664237,43,15,1970,10,male,241.0,89,73,2,8,2,8,0,0,1
628,35426,1875795,26,14,1987,9,female,649.0,48,28,464,242,463,146,1,96,0
629,54723,2184314,63,25,1950,2,female,2103.0,100,36,9,65,6,24,3,41,0
630,9038,1847698,16,27,1997,12,male,49.0,8,6,1,0,1,0,0,0,1
631,78097,1170202,22,2,1991,5,female,1071.0,239,122,783,167,235,114,548,53,0
632,95540,1438274,18,24,1995,11,male,489.0,845,600,193,414,193,322,0,92,1
633,32621,1712962,63,21,1950,9,female,33.0,44,31,0,0,0,0,0,0,0
634,10837,1101901,40,15,1973,6,female,81.0,10,2,2058,23,1903,16,155,7,0
635,53504,1503631,17,21,1996,3,male,33.0,96,83,3,43,3,39,0,4,0
636,74425,1952629,17,7,1996,11,male,422.0,208,125,7,38,7,20,0,18,1
637,91709,1697701,15,18,1998,3,male,272.0,548,396,232,190,170,38,62,152,1
638,73402,1074523,21,15,1992,10,male,546.0,200,43,6,5,6,4,0,1,1
639,74416,1175889,14,6,1999,1,female,378.0,212,149,7,4,4,2,3,2,1
640,61894,1337051,83,28,1930,5,female,1414.0,128,34,78,4,0,1,78,3,1
641,4851,1963421,23,1,1990,1,female,814.0,2,0,54,0,53,0,1,0,1
642,32260,1085856,37,4,1976,5,female,457.0,43,30,119,151,92,135,27,16,1
643,44548,1045089,42,24,1971,6,male,1409.0,70,24,4,4,4,1,0,3,1
644,64380,1766875,52,11,1961,12,female,1560.0,144,65,1,5,0,0,1,5,1
645,20366,1972288,53,11,1960,9,male,584.0,24,11,33,10,33,8,0,2,0
646,66036,1243711,68,7,1945,10,female,68.0,146,133,182,88,0,6,182,82,1
647,85692,1260570,23,10,1990,2,female,654.0,340,234,87,84,60,15,27,69,0
648,88975,1841389,51,30,1962,12,female,1600.0,419,333,586,1154,420,621,166,533,0
649,13774,1447154,63,13,1950,10,female,874.0,15,7,0,0,0,0,0,0,1
650,42196,1923976,45,20,1968,6,male,365.0,62,30,81,17,0,3,81,14,0
651,83471,1785955,29,10,1984,2,male,1466.0,318,136,18,3,18,2,0,1,0
652,72993,1653288,40,2,1973,8,female,700.0,196,140,340,436,293,364,47,72,1
653,96035,1448651,16,4,1997,7,female,674.0,1009,187,0,59,0,45,0,14,0
654,62120,1569828,32,4,1981,12,female,323.0,126,70,365,1321,289,927,76,394,1
655,61963,1423204,28,9,1985,4,male,796.0,128,91,117,92,93,62,24,30,1
656,90207,1285820,25,30,1988,10,male,568.0,486,272,3,0,0,0,3,0,1
657,36346,1194969,14,16,1999,11,male,63.0,51,45,168,77,78,51,90,26,0
658,31130,1622977,80,25,1933,4,male,1541.0,40,18,115,19,115,12,0,7,0
659,38318,1278648,36,13,1977,11,male,72.0,55,37,853,45,853,44,0,1,1
660,87367,1592212,16,18,1997,2,male,521.0,389,166,9,11,9,3,0,8,0
661,67635,1772722,30,14,1983,9,female,366.0,159,133,16,1,4,1,12,0,0
662,42272,1621088,28,15,1985,3,male,726.0,62,42,129,7,129,5,0,2,0
663,65106,1590086,20,27,1993,4,male,300.0,144,95,804,44,804,43,0,1,1
664,46912,1314301,28,25,1985,12,female,1364.0,74,38,13,115,13,96,0,19,0
665,88891,1737288,19,16,1994,11,female,435.0,435,107,336,421,195,243,141,178,0
666,38163,1726631,18,15,1995,12,male,210.0,55,36,72,71,72,40,0,31,0
667,12714,1109450,61,17,1952,10,male,187.0,14,12,1,10,0,0,1,10,1
668,62335,1716591,39,3,1974,4,male,492.0,133,58,0,0,0,0,0,0,0
669,48587,1535529,17,14,1996,12,male,312.0,80,69,4,13,4,13,0,0,1
670,56382,1597650,23,14,1990,8,male,197.0,107,106,0,0,0,0,0,0,0
671,30341,1645054,83,29,1930,10,male,1585.0,40,15,0,0,0,0,0,0,1
672,39197,1687860,19,25,1994,8,female,177.0,56,38,849,1145,849,395,0,750,0
673,79454,1278908,18,8,1995,8,male,225.0,259,132,14,15,14,12,0,3,1
674,15674,1863217,27,24,1986,2,male,473.0,18,12,0,0,0,0,0,0,0
675,33129,1231000,62,25,1951,1,female,1189.0,44,30,29,2,29,2,0,0,0
676,14586,1169279,47,29,1966,1,male,69.0,16,13,0,0,0,0,0,0,1
677,4153,1942631,32,12,1981,5,female,209.0,2,1,0,0,0,0,0,0,0
678,2778,1702877,37,4,1976,11,male,717.0,1,0,0,0,0,0,0,0,1
679,29213,1021117,56,7,1957,2,male,363.0,38,19,38,4,0,2,38,2,0
680,4888,1242548,33,16,1980,1,male,216.0,2,2,194,67,0,10,194,57,0
681,95588,1442915,108,5,1905,2,male,1455.0,875,365,249,138,249,106,0,32,0
682,29439,1420445,65,26,1948,3,female,641.0,37,35,430,181,4,38,426,143,1
683,91728,2067300,29,5,1984,9,male,678.0,524,317,249,282,190,168,59,114,0
684,6869,1295990,62,1,1951,4,male,29.0,5,5,0,0,0,0,0,0,0
685,2804,1429457,37,9,1976,2,male,304.0,1,0,0,0,0,0,0,0,0
686,290,1750800,19,21,1994,8,male,769.0,0,0,0,0,0,0,0,0,0
687,12171,1133086,14,1,1999,3,female,296.0,13,11,0,0,0,0,0,0,0
688,92286,1550050,24,18,1989,8,male,272.0,600,314,16,0,0,0,16,0,0
689,92799,1095533,18,13,1995,12,male,629.0,604,289,409,395,17,160,392,235,1
690,79137,1956225,19,1,1994,1,male,639.0,258,194,0,3,0,2,0,1,0
691,93037,1101734,14,16,1999,12,female,327.0,628,72,3240,1480,1311,342,1929,1138,1
692,45092,1505085,16,12,1997,5,male,154.0,71,50,0,0,0,0,0,0,1
693,91760,1802722,32,2,1981,4,male,759.0,519,200,297,440,297,343,0,97,0
694,89639,1460865,65,15,1948,1,female,1432.0,471,164,92,166,56,70,36,96,0
695,70902,1624687,29,1,1984,10,female,532.0,177,54,144,16,0,1,144,15,1
696,82450,1409553,26,3,1987,6,male,991.0,299,184,15,3,3,2,12,1,1
697,16997,1262839,25,1,1988,1,male,52.0,20,16,3,3,3,3,0,0,0
698,89950,1691800,19,29,1994,9,female,530.0,460,355,662,240,438,120,224,120,1
699,79211,1061154,21,2,1992,2,female,643.0,255,183,1,0,0,0,1,0,1
700,17432,1054342,36,10,1977,6,male,485.0,19,12,30,15,30,5,0,10,1
701,64416,1594794,28,16,1985,7,female,354.0,144,96,1,51,1,41,0,10,0
702,12944,1156793,24,9,1989,7,male,37.0,13,13,3,5,0,1,3,4,0
703,16761,1024339,35,10,1978,6,male,226.0,19,10,1,28,0,9,1,19,0
704,5140,1569038,29,10,1984,8,female,696.0,3,2,0,0,0,0,0,0,1
705,34876,1672030,31,24,1982,4,female,95.0,48,30,4,2,4,1,0,1,1
706,47631,1852816,113,1,1900,4,male,1255.0,77,23,0,0,0,0,0,0,0
707,78319,1064480,30,28,1983,11,male,333.0,243,76,2,22,0,2,2,20,0
708,77052,1149518,26,23,1987,10,female,107.0,229,181,603,381,164,195,439,186,0
709,7767,2065432,44,16,1969,11,male,634.0,6,4,0,0,0,0,0,0,1
710,39952,2073313,76,14,1937,1,female,1275.0,59,23,81,47,65,25,16,22,1
711,84675,1567248,16,26,1997,3,female,337.0,324,99,69,58,69,57,0,1,1
712,66791,1071833,20,29,1993,9,female,469.0,153,72,38,0,38,0,0,0,0
713,68247,1537991,21,10,1992,10,female,471.0,167,34,0,1,0,1,0,0,1
714,34326,1250367,38,28,1975,5,female,141.0,46,35,97,5,97,5,0,0,0
715,11691,1748868,40,11,1973,7,male,417.0,12,12,0,0,0,0,0,0,0
716,97242,1357973,20,6,1993,8,male,1118.0,1799,1171,38,58,31,51,7,7,0
717,28199,2085914,108,1,1905,6,,2265.0,36,17,75,122,53,42,22,80,0
718,87295,1535003,34,10,1979,11,male,718.0,408,344,4,36,4,32,0,4,1
719,36047,1498227,44,17,1969,8,male,399.0,51,37,18,3,18,0,0,3,1
720,20969,1902697,53,3,1960,3,male,126.0,25,21,17,7,17,4,0,3,1
721,27394,1483272,68,14,1945,1,male,618.0,34,30,31,0,1,0,30,0,1
722,17079,1117405,23,8,1990,11,male,236.0,19,15,5,1,5,1,0,0,1
723,73341,1975349,23,17,1990,7,male,343.0,198,188,3,8,2,8,1,0,1
724,79358,1227373,28,28,1985,1,female,899.0,258,52,6,31,3,27,3,4,0
725,48279,1999579,20,3,1993,6,female,622.0,81,46,0,0,0,0,0,0,0
726,50277,1353655,29,23,1984,9,female,447.0,82,58,928,104,928,54,0,50,0
727,13612,1531383,21,20,1992,2,male,522.0,15,7,0,0,0,0,0,0,1
728,60859,1508867,33,16,1980,8,male,28.0,123,118,55,10,55,10,0,0,1
729,90915,1776442,29,3,1984,4,male,373.0,516,327,603,646,603,605,0,41,1
730,35848,1486799,19,6,1994,8,male,73.0,51,36,4,3,4,2,0,1,1
731,48529,2037358,30,12,1983,2,male,158.0,81,65,2,8,2,0,0,8,1
732,44320,1527157,28,1,1985,12,male,444.0,69,28,0,0,0,0,0,0,0
733,1224,1367312,36,20,1977,10,female,13.0,0,0,0,0,0,0,0,0,0
734,72338,1838941,106,11,1907,12,male,983.0,196,77,1,1,1,1,0,0,0
735,52819,2022802,23,30,1990,6,male,135.0,91,50,33,69,33,57,0,12,0
736,19826,1173530,26,27,1987,11,male,862.0,24,23,0,0,0,0,0,0,0
737,6807,1146956,45,27,1968,4,male,283.0,5,5,0,0,0,0,0,0,1
738,75144,1738340,20,20,1993,11,male,355.0,213,43,0,0,0,0,0,0,0
739,58425,1515188,25,1,1988,1,male,218.0,113,51,2,0,2,0,0,0,0
740,87110,1990967,20,17,1993,11,female,63.0,368,80,3266,828,3266,491,0,337,1
741,36398,1064941,63,10,1950,1,female,27.0,51,50,333,128,52,72,281,56,0
742,64282,1008198,22,17,1991,6,male,226.0,141,111,0,0,0,0,0,0,1
743,6511,1153151,14,9,1999,7,female,88.0,5,5,0,0,0,0,0,0,1
744,6929,2023879,47,30,1966,10,male,30.0,5,1,1,1,0,1,1,0,1
745,19599,1348668,33,15,1980,6,male,200.0,22,14,70,11,70,11,0,0,1
746,36892,1962530,32,16,1981,3,male,296.0,53,33,5,0,5,0,0,0,1
747,76175,1028830,16,22,1997,5,female,979.0,224,94,0,0,0,0,0,0,1
748,808,1502861,27,2,1986,2,male,14.0,0,0,0,0,0,0,0,0,1
749,79121,1182894,18,1,1995,1,male,430.0,256,170,0,1,0,0,0,1,0
750,30315,2072195,63,3,1950,3,male,2199.0,40,28,0,0,0,0,0,0,0
751,73933,1235422,18,17,1995,5,male,599.0,201,151,283,14,277,11,6,3,0
752,11677,1163194,34,29,1979,10,male,277.0,12,4,0,0,0,0,0,0,1
753,79601,1916860,52,23,1961,2,male,299.0,259,97,36,13,36,10,0,3,1
754,38850,1535041,58,26,1955,12,female,269.0,56,33,20,15,2,10,18,5,1
755,9994,1311483,60,21,1953,3,male,930.0,10,4,0,0,0,0,0,0,1
756,67175,1570251,46,10,1967,8,female,718.0,152,66,491,561,311,419,180,142,1
757,46733,1688955,29,5,1984,1,male,549.0,75,22,4,0,1,0,3,0,0
758,95669,1520019,18,8,1995,3,male,982.0,909,671,375,183,375,119,0,64,1
759,90733,1361372,17,26,1996,7,male,438.0,483,205,184,292,42,86,142,206,1
760,32480,1691975,25,3,1988,1,male,222.0,45,27,0,1,0,1,0,0,0
761,33122,2116972,18,6,1995,5,male,48.0,44,39,28,3,28,0,0,3,0
762,26037,1903410,19,25,1994,5,female,46.0,33,28,16,4,16,4,0,0,1
763,37554,1703367,49,10,1964,12,female,427.0,54,23,0,0,0,0,0,0,0
764,77571,1330050,54,12,1959,10,female,1190.0,239,97,24,48,7,29,17,19,0
765,64838,1665134,21,1,1992,4,female,635.0,142,58,58,84,44,47,14,37,0
766,87206,1802576,108,31,1905,12,male,1181.0,409,76,1,4,0,2,1,2,1
767,91789,1200434,21,13,1992,7,female,363.0,548,476,394,204,26,27,368,177,0
768,59623,1743563,75,29,1938,10,female,1788.0,119,41,8,33,1,26,7,7,0
769,1158,1256256,34,9,1979,8,male,22.0,0,0,0,0,0,0,0,0,0
770,53305,1008138,33,1,1980,10,male,419.0,97,56,0,7,0,2,0,5,1
771,36478,2082116,19,12,1994,12,male,490.0,52,43,0,0,0,0,0,0,1
772,35833,1941235,31,1,1982,10,male,537.0,50,27,4,0,1,0,3,0,0
773,2757,1449265,36,12,1977,11,male,276.0,1,0,0,0,0,0,0,0,1
774,9523,2090907,22,30,1991,12,male,104.0,10,7,0,2,0,0,0,2,1
775,15289,1911070,23,3,1990,7,male,301.0,16,7,21,1,21,1,0,0,1
776,76585,1512615,27,23,1986,2,male,680.0,222,139,22,34,18,10,4,24,0
777,42198,1301425,48,1,1965,1,male,1907.0,64,36,84,87,70,69,14,18,0
778,23465,1129869,64,18,1949,12,female,1208.0,29,17,0,0,0,0,0,0,1
779,15356,1293733,26,1,1987,1,male,454.0,17,13,34,0,34,0,0,0,0
780,43017,1683865,28,26,1985,9,female,564.0,66,49,21,101,20,60,1,41,0
781,56696,1141491,26,1,1987,1,female,338.0,105,56,10,11,10,11,0,0,1
782,83264,1321373,24,23,1989,5,male,1435.0,312,52,2,57,1,41,1,16,1
783,9251,1030733,39,18,1974,10,female,287.0,8,7,8,6,8,5,0,1,0
784,97657,1712392,15,13,1998,2,female,580.0,1542,1072,570,390,475,96,95,294,1
785,10835,1845774,22,1,1991,7,female,143.0,10,7,1635,81,0,15,1635,66,0
786,64614,1445578,17,4,1996,9,female,336.0,143,106,11,15,10,13,1,2,0
787,57580,1026848,32,9,1981,9,male,566.0,108,67,8,14,3,4,5,10,1
788,96051,1464168,23,30,1990,12,male,731.0,1031,936,0,7,0,1,0,6,0
789,64960,1476695,52,15,1961,12,male,884.0,143,53,180,202,114,134,66,68,0
790,69339,1422108,102,11,1911,11,male,705.0,173,171,0,8,0,5,0,3,1
791,92780,1327800,17,31,1996,10,male,357.0,602,471,350,979,102,558,248,421,1
792,21872,1318029,65,10,1948,12,female,1183.0,27,14,4,19,4,15,0,4,1
793,72379,2189845,22,1,1991,4,male,352.0,193,85,2,2,2,2,0,0,1
794,2407,1172517,25,1,1988,1,male,34.0,1,1,0,0,0,0,0,0,1
795,20311,1718219,78,29,1935,8,female,23.0,24,21,18,12,3,0,15,12,1
796,45736,1785866,20,21,1993,8,male,625.0,71,35,16,2,16,2,0,0,1
797,2514,1153617,27,22,1986,9,male,108.0,1,1,0,0,0,0,0,0,0
798,17669,1675983,49,25,1964,7,female,239.0,20,10,2384,431,2384,410,0,21,1
799,29210,1839522,51,10,1962,6,male,27.0,37,31,36,41,36,33,0,8,1
800,52594,1706398,46,9,1967,12,male,712.0,92,49,5,11,5,8,0,3,1
801,63022,2020608,68,15,1945,3,male,1201.0,132,60,154,90,38,68,116,22,1
802,95548,1906911,20,1,1993,8,female,363.0,993,453,203,636,203,610,0,26,0
803,41815,1103600,59,28,1954,5,female,1499.0,62,19,14,19,1,4,13,15,1
804,18291,2173490,31,6,1982,12,male,712.0,21,14,58,66,58,19,0,47,0
805,60678,2103599,21,29,1992,6,female,295.0,122,41,13,100,13,65,0,35,0
806,74927,1930490,18,15,1995,9,female,245.0,209,132,215,160,215,97,0,63,1
807,59247,1263780,20,22,1993,2,male,831.0,116,34,0,16,0,4,0,12,1
808,7896,1472741,62,14,1951,12,male,226.0,6,0,0,2,0,2,0,0,1
809,66429,1077710,67,5,1946,9,female,809.0,154,129,2,9,0,5,2,4,0
810,50741,1407684,28,8,1985,5,male,267.0,85,19,10,0,5,0,5,0,0
811,37753,1236006,18,4,1995,4,male,325.0,55,37,4,1,4,1,0,0,0
812,72226,1469145,20,29,1993,6,female,172.0,195,19,0,7,0,4,0,3,1
813,31118,1948217,41,2,1972,8,female,351.0,41,19,108,53,108,49,0,4,0
814,86345,1785380,21,15,1992,5,female,426.0,373,77,7,18,7,9,0,9,0
815,73422,1700336,26,28,1987,5,male,296.0,202,122,7,15,7,8,0,7,0
816,92384,2104962,19,10,1994,10,female,289.0,579,401,34,619,34,385,0,234,0
817,97100,1861402,31,23,1982,5,female,1354.0,1576,325,5,1313,1,837,4,476,1
818,61066,1785170,77,26,1936,6,female,443.0,122,46,368,562,0,52,368,510,1
819,5904,1305264,24,1,1989,3,male,139.0,4,0,0,0,0,0,0,0,1
820,56505,1690062,76,27,1937,2,male,1522.0,107,57,1,0,1,0,0,0,0
821,90205,1201256,39,21,1974,12,male,347.0,508,378,2,5,2,4,0,1,1
822,50132,1672859,36,28,1977,12,female,569.0,83,71,131,7,126,0,5,7,1
823,40510,1606862,54,13,1959,11,female,221.0,61,38,7,0,7,0,0,0,0
824,28372,1728907,22,8,1991,12,female,342.0,38,3,0,0,0,0,0,0,1
825,13981,1810841,20,8,1993,1,male,25.0,15,8,4,0,4,0,0,0,0
826,22782,2058059,30,30,1983,1,female,297.0,28,13,4,0,4,0,0,0,0
827,10247,1303756,34,2,1979,4,male,652.0,9,2,2,4,0,2,2,2,1
828,85495,1405264,42,6,1971,3,female,573.0,353,211,26,13,0,3,26,10,0
829,76869,1495268,16,5,1997,7,female,533.0,230,118,131,67,57,56,74,11,0
830,61717,1774684,47,18,1966,9,male,110.0,129,34,27,20,27,19,0,1,0
831,84654,2193156,61,3,1952,9,female,961.0,326,217,64,122,19,14,45,108,1
832,30514,2078786,34,8,1979,10,male,329.0,40,17,2,22,2,9,0,13,0
833,23485,1864809,68,7,1945,12,male,329.0,30,22,0,2,0,1,0,1,1
834,71383,1264862,22,22,1991,6,male,56.0,183,165,3,13,3,12,0,1,1
835,29099,1529872,17,26,1996,8,male,36.0,37,30,19,55,19,55,0,0,1
836,94361,2178013,22,29,1991,4,male,1027.0,743,624,42,22,11,16,31,6,0
837,44048,1498767,54,25,1959,5,female,698.0,67,21,73,24,73,15,0,9,0
838,36046,2178133,22,21,1991,5,male,52.0,50,50,18,7,18,6,0,1,1
839,42476,1007297,16,3,1997,9,female,367.0,65,28,0,0,0,0,0,0,0
840,58370,1554260,13,24,2000,2,male,119.0,112,36,1,2,1,2,0,0,0
841,9526,1738304,21,29,1992,2,male,545.0,10,6,0,0,0,0,0,0,1
842,39836,1909883,23,16,1990,6,female,157.0,58,34,29,16,29,14,0,2,0
843,40081,1935872,23,8,1990,1,male,108.0,59,45,311,62,311,60,0,2,0
844,86683,1569155,103,29,1910,3,female,1686.0,379,199,92,76,80,38,12,38,1
845,49264,2148026,13,16,2000,4,female,77.0,79,65,868,283,868,270,0,13,0
846,89110,1089270,15,13,1998,1,female,106.0,438,212,5447,2930,5447,1975,0,955,0
847,63753,1968233,18,25,1995,8,male,390.0,136,77,23,0,23,0,0,0,1
848,3178,1548570,27,17,1986,8,male,899.0,1,1,1,1,0,0,1,1,0
849,38179,2105955,23,8,1990,1,male,196.0,55,13,86,16,86,11,0,5,1
850,20960,2076784,50,20,1963,5,male,1432.0,25,9,16,2,12,1,4,1,0
851,39659,1435228,76,1,1937,11,male,1479.0,58,30,9,10,0,9,9,1,1
852,3277,2147521,18,15,1995,4,female,195.0,1,1,1,1,1,1,0,0,1
853,38976,1940426,19,25,1994,8,female,458.0,57,32,49,8,49,2,0,6,0
854,39805,1415826,27,5,1986,6,male,276.0,58,39,25,13,22,10,3,3,0
855,31909,1356745,71,22,1942,9,female,1580.0,42,17,10,7,9,3,1,4,1
856,46135,1028050,49,5,1964,2,female,351.0,72,62,175,9,175,6,0,3,0
857,69410,1172819,21,3,1992,11,male,324.0,175,105,2,1,2,1,0,0,0
858,16537,1560258,39,15,1974,12,male,241.0,20,18,0,0,0,0,0,0,1
859,76582,1155710,52,21,1961,6,female,1550.0,227,141,21,33,21,23,0,10,1
860,77068,1584183,41,22,1972,2,female,501.0,224,190,710,679,536,276,174,403,1
861,18211,1861590,26,1,1987,1,male,333.0,21,18,21,2,21,0,0,2,0
862,10983,1222398,34,1,1979,3,female,247.0,11,10,0,0,0,0,0,0,0
863,87174,1834976,25,8,1988,8,male,1118.0,404,354,0,0,0,0,0,0,0
864,40642,1944583,27,6,1986,3,male,517.0,61,18,20,0,0,0,20,0,0
865,51896,1648077,33,4,1980,9,male,388.0,89,80,35,9,35,6,0,3,0
866,71283,2029419,23,30,1990,7,female,463.0,185,129,1,0,1,0,0,0,1
867,85054,2191145,42,6,1971,8,female,279.0,323,213,1466,2554,1144,1272,322,1282,1
868,5676,1241887,42,1,1971,1,male,38.0,3,2,19,23,16,9,3,14,0
869,72012,1886865,17,22,1996,10,male,331.0,186,157,288,287,256,138,32,149,1
870,17005,2057409,21,5,1992,2,male,33.0,20,15,3,33,3,21,0,12,0
871,46648,2092407,20,13,1993,6,female,149.0,75,63,2,0,2,0,0,0,1
872,90619,1202123,20,30,1993,9,male,558.0,498,226,105,113,105,108,0,5,1
873,35112,1268466,32,25,1981,9,male,409.0,48,32,25,22,0,6,25,16,1
874,34951,2103651,20,2,1993,2,male,366.0,49,31,8,0,8,0,0,0,0
875,8408,2070468,101,12,1912,12,female,450.0,7,6,9,1,1,0,8,1,1
876,94998,1506794,18,16,1995,9,female,788.0,744,459,2576,947,66,212,2510,735,0
877,52518,1359764,41,10,1972,6,male,531.0,93,43,3,0,0,0,3,0,0
878,15216,1343963,21,17,1992,4,female,536.0,16,9,13,10,11,6,2,4,1
879,7233,1538132,38,3,1975,7,male,421.0,5,3,28,4,28,1,0,3,1
880,37476,1729882,23,8,1990,11,male,342.0,55,35,0,2,0,0,0,2,0
881,11503,1889341,25,17,1988,1,female,64.0,11,7,261,101,261,26,0,75,1
882,23699,1090755,22,1,1991,1,male,1299.0,30,12,2,0,2,0,0,0,1
883,81711,1606111,57,2,1956,10,female,1816.0,279,50,88,240,87,160,1,80,1
884,87023,1244980,35,1,1978,1,female,708.0,360,211,787,340,201,167,586,173,1
885,66224,1264401,37,15,1976,11,male,550.0,148,94,1777,4291,890,2684,887,1607,1
886,13277,1584798,22,25,1991,6,female,369.0,14,7,17,9,9,3,8,6,1
887,73514,1361217,31,2,1982,10,male,474.0,198,125,15,226,15,214,0,12,1
888,19554,1667511,36,9,1977,6,female,246.0,22,6,44,32,44,29,0,3,1
889,5948,1226294,27,20,1986,6,male,152.0,4,3,0,1,0,1,0,0,0
890,96649,1059722,24,5,1989,7,female,729.0,1139,762,440,265,440,230,0,35,0
891,50330,2062224,21,8,1992,11,female,600.0,87,43,0,0,0,0,0,0,1
892,65240,2114033,26,1,1987,1,male,382.0,150,95,0,0,0,0,0,0,0
893,69629,2120749,36,19,1977,11,male,1417.0,171,89,18,25,17,8,1,17,0
894,65437,1824186,105,29,1908,2,male,1120.0,150,82,3,9,0,2,3,7,1
895,57082,1781562,58,26,1955,9,male,1376.0,105,65,341,174,341,98,0,76,0
896,30263,1173782,37,11,1976,10,male,448.0,41,16,0,84,0,40,0,44,0
897,98557,1210384,17,10,1996,6,male,503.0,2012,528,568,1581,104,360,464,1221,1
898,17781,1048740,29,20,1984,10,female,255.0,21,4,0,0,0,0,0,0,0
899,41009,1829813,50,24,1963,9,female,184.0,61,31,688,356,3,15,685,341,1
900,72089,1783555,36,13,1977,5,female,241.0,185,96,591,270,591,239,0,31,0
901,9084,1199386,67,14,1946,9,male,1728.0,8,5,1,1,1,1,0,0,0
902,56898,1632987,18,20,1995,2,male,66.0,105,90,54,16,54,14,0,2,1
903,38235,1388093,102,24,1911,11,male,1140.0,54,38,152,17,0,8,152,9,0
904,46139,1969590,61,26,1952,11,female,708.0,72,49,185,48,185,43,0,5,1
905,11099,1895577,73,31,1940,10,male,1011.0,11,3,0,3,0,2,0,1,1
906,28410,1077171,24,28,1989,7,female,330.0,38,19,0,0,0,0,0,0,1
907,68726,1284321,18,4,1995,11,male,223.0,169,112,30,18,14,2,16,16,0
908,88957,1461767,58,29,1955,5,male,1769.0,414,291,512,98,417,62,95,36,0
909,89151,1365650,21,12,1992,5,male,330.0,443,313,0,0,0,0,0,0,0
910,28371,1068976,20,26,1993,9,male,255.0,38,12,0,0,0,0,0,0,0
911,44124,1880850,59,15,1954,4,female,319.0,67,43,146,2,146,2,0,0,0
912,1076,1489408,32,21,1981,9,female,134.0,0,0,0,0,0,0,0,0,1
913,76535,1508352,21,2,1992,1,male,218.0,230,137,14,21,14,17,0,4,1
914,6713,1351762,32,11,1981,7,male,20.0,5,5,0,0,0,0,0,0,0
915,88579,1477063,15,6,1998,1,female,184.0,434,140,60,94,22,47,38,47,1
916,988,2129308,30,6,1983,10,male,33.0,0,0,0,0,0,0,0,0,0
917,84125,1142530,15,29,1998,10,male,174.0,324,290,0,19,0,15,0,4,0
918,85085,2029292,47,19,1966,8,female,1325.0,332,220,3776,1966,3471,1728,305,238,1
919,78551,1377468,62,26,1951,10,male,795.0,249,54,19,52,0,1,19,51,0
920,3432,1039717,16,3,1997,7,female,56.0,1,1,4,0,0,0,4,0,0
921,23490,1680218,70,7,1943,12,male,715.0,30,20,0,0,0,0,0,0,0
922,6166,1543283,68,19,1945,5,male,445.0,4,4,0,0,0,0,0,0,0
923,92540,1086332,16,25,1997,9,female,673.0,574,378,104,232,54,148,50,84,0
924,56389,1755845,24,22,1989,6,female,305.0,107,32,0,0,0,0,0,0,1
925,8525,1569537,37,1,1976,1,female,763.0,7,4,22,3,22,3,0,0,1
926,9262,1805938,66,10,1947,7,male,242.0,8,6,10,0,10,0,0,0,1
927,57651,1104241,24,29,1989,7,female,242.0,109,51,13,92,13,73,0,19,1
928,51051,1140025,19,10,1994,11,female,244.0,86,33,70,5,70,5,0,0,1
929,19236,1032117,24,17,1989,7,female,92.0,23,21,8,67,8,67,0,0,0
930,55712,1970266,46,20,1967,9,male,2202.0,101,38,9,30,9,30,0,0,1
931,58171,1005334,31,7,1982,7,female,193.0,111,82,1156,509,1156,322,0,187,0
932,6683,2055557,29,12,1984,6,female,743.0,5,2,0,0,0,0,0,0,0
933,78570,1618909,26,17,1987,10,male,389.0,241,191,22,37,22,30,0,7,0
934,17199,1622292,22,15,1991,11,male,48.0,19,11,9,1,3,0,6,1,1
935,17334,1156871,58,2,1955,2,,1822.0,19,10,17,32,17,28,0,4,0
936,46555,1369655,27,6,1986,1,male,90.0,76,14,1,0,1,0,0,0,1
937,5090,1096298,26,1,1987,1,female,612.0,3,1,0,0,0,0,0,0,1
938,22940,1837218,50,14,1963,8,female,1743.0,28,21,22,6,14,2,8,4,1
939,37007,1701050,21,30,1992,6,male,791.0,52,31,11,24,11,24,0,0,0
940,12684,2035826,57,11,1956,2,male,1706.0,13,6,1,0,0,0,1,0,1
941,75486,1738697,27,3,1986,10,male,846.0,214,154,11,32,11,31,0,1,0
942,47143,1042907,25,30,1988,9,male,144.0,75,70,51,7,51,7,0,0,0
943,39088,1490001,108,25,1905,2,male,1047.0,57,41,124,18,0,7,124,11,1
944,47220,1096828,72,27,1941,4,female,649.0,76,71,83,23,0,3,83,20,0
945,64392,1716666,22,16,1991,12,male,420.0,142,133,1,0,1,0,0,0,0
946,18179,1418866,64,20,1949,11,male,919.0,21,10,16,6,16,4,0,2,0
947,79833,1778555,105,8,1908,11,,1357.0,252,163,162,46,136,29,26,17,1
948,50199,1449760,38,5,1975,7,female,252.0,82,51,237,212,237,181,0,31,0
949,49338,1024186,20,24,1993,8,male,559.0,82,40,0,0,0,0,0,0,1
950,17813,1922937,39,6,1974,12,male,227.0,21,4,0,0,0,0,0,0,1
951,5578,1632536,37,3,1976,1,male,539.0,3,3,4,1,4,0,0,1,0
952,46572,2185322,25,1,1988,1,male,273.0,76,74,1,1,1,1,0,0,1
953,9886,1436276,46,1,1967,1,female,411.0,10,8,0,1,0,0,0,1,0
954,14164,2023269,46,12,1967,7,female,241.0,15,11,38,48,38,36,0,12,0
955,19275,2037325,58,4,1955,2,female,1535.0,23,18,10,3,10,1,0,2,1
956,8792,2129329,24,12,1989,1,male,117.0,8,7,0,0,0,0,0,0,1
957,22182,1819229,57,5,1956,5,female,1422.0,27,8,25,56,25,17,0,39,0
958,16576,1417689,44,28,1969,10,female,110.0,20,15,0,0,0,0,0,0,1
959,65639,1097273,18,20,1995,12,male,477.0,147,105,15,14,0,0,15,14,0
960,90099,1638638,17,4,1996,5,male,533.0,489,426,0,9,0,8,0,1,0
961,16316,1745425,17,21,1996,7,male,264.0,19,18,0,0,0,0,0,0,1
962,37227,1460213,61,20,1952,9,female,1074.0,53,15,65,0,65,0,0,0,0
963,17522,1547135,31,8,1982,6,male,43.0,19,10,59,29,59,17,0,12,1
964,78819,1151036,20,12,1993,5,male,45.0,250,185,123,68,123,64,0,4,0
965,94690,2080858,19,13,1994,9,female,351.0,780,139,290,1058,290,856,0,202,0
966,66966,1983301,81,5,1932,9,male,817.0,156,49,100,14,100,10,0,4,1
967,29843,1104513,48,6,1965,5,male,200.0,39,30,13,16,1,3,12,13,0
968,80091,1841280,15,14,1998,11,male,306.0,265,245,0,2,0,1,0,1,0
969,83708,1434690,108,30,1905,9,male,906.0,305,134,95,18,95,17,0,1,1
970,30900,1684110,21,15,1992,12,male,336.0,40,24,26,14,26,14,0,0,0
971,89849,1615766,18,30,1995,3,male,301.0,450,261,322,233,311,139,11,94,0
972,98171,1366239,18,12,1995,8,female,574.0,3179,1382,29,68,29,56,0,12,1
973,82390,1363543,24,17,1989,12,male,153.0,296,187,8,38,8,3,0,35,1
974,48283,2016741,21,2,1992,2,male,269.0,81,50,0,0,0,0,0,0,0
975,81523,2073717,18,25,1995,12,male,73.0,276,229,31,191,31,185,0,6,1
976,27765,2159439,31,9,1982,1,male,137.0,36,18,0,1,0,1,0,0,0
977,1347,2145218,41,11,1972,8,male,393.0,0,0,0,0,0,0,0,0,0
978,77805,1585979,52,11,1961,12,female,534.0,237,168,98,436,0,119,98,317,1
979,49467,1654786,108,13,1905,3,female,942.0,82,48,0,0,0,0,0,0,1
980,23218,2077684,23,11,1990,3,female,215.0,30,18,0,2,0,1,0,1,1
981,65791,2162603,17,4,1996,8,male,272.0,145,128,40,2,20,2,20,0,1
982,46528,2168930,31,1,1982,1,male,381.0,74,40,1,0,0,0,1,0,1
983,12492,1584908,36,6,1977,10,male,114.0,13,12,0,0,0,0,0,0,0
984,24593,2179803,28,5,1985,5,male,607.0,31,17,0,2,0,2,0,0,1
985,62162,2142311,44,21,1969,3,male,291.0,126,54,650,256,650,207,0,49,0
986,43316,2106386,65,10,1948,6,female,845.0,66,36,289,89,225,41,64,48,1
987,22142,1524296,34,5,1979,10,male,108.0,26,21,19,3,19,3,0,0,1
988,19995,1432733,16,20,1997,7,male,233.0,24,18,1,0,1,0,0,0,1
989,1844,1378143,30,13,1983,2,male,25.0,0,0,3,1,3,1,0,0,1
990,43863,1105678,45,15,1968,6,male,483.0,67,50,19,2,16,2,3,0,0
991,48466,1411313,29,20,1984,4,female,376.0,80,37,1,1,1,1,0,0,1
992,26277,2185860,31,3,1982,3,male,85.0,33,30,65,3,65,1,0,2,1
993,54849,1434846,42,1,1971,12,male,643.0,100,58,23,26,23,20,0,6,1
994,1870,1887403,22,13,1991,3,male,23.0,0,0,4,4,4,2,0,2,1
995,95882,1296487,68,22,1945,5,male,1022.0,912,796,1177,85,1177,71,0,14,1
996,13182,1094027,21,30,1992,9,female,275.0,13,2,10,0,10,0,0,0,0
997,10760,1231959,32,3,1981,2,male,15.0,10,10,64,152,53,108,11,44,0
998,43360,1204840,15,12,1998,8,female,346.0,66,41,659,612,659,279,0,333,1
999,48551,2015875,35,2,1978,1,female,563.0,81,38,3,0,3,0,0,0,0
1000,16675,2073169,65,26,1948,1,male,1349.0,19,3,0,1,0,0,0,1,1
1001,15989,1056321,33,10,1980,6,male,190.0,18,17,4,0,4,0,0,0,1
1002,38161,2015892,57,18,1956,1,male,300.0,55,39,73,2,73,2,0,0,1
1003,61611,1914140,27,17,1986,10,female,244.0,128,71,12,5,12,5,0,0,0
1004,79255,2107508,101,26,1912,6,female,1532.0,253,65,2,1,1,1,1,0,0
1005,27108,2057214,30,8,1983,8,female,706.0,35,18,5,1,5,1,0,0,1
1006,44782,1732083,21,2,1992,3,female,1033.0,70,31,32,234,19,40,13,194,1
1007,22332,1882966,20,5,1993,2,female,134.0,26,20,87,13,87,13,0,0,0
1008,86242,1311148,35,3,1978,4,male,1098.0,372,246,1,38,1,37,0,1,0
1009,78072,1890453,40,12,1973,3,male,321.0,234,224,564,150,290,98,274,52,1
1010,26413,1053414,34,9,1979,8,female,45.0,33,28,292,216,236,180,56,36,1
1011,62783,1290519,23,3,1990,1,female,344.0,132,114,31,66,31,49,0,17,0
1012,4524,1171802,20,28,1993,8,male,611.0,2,0,1,0,1,0,0,0,0
1013,20729,1138160,64,4,1949,9,female,131.0,25,15,1,5,0,4,1,1,0
1014,95248,1032955,22,10,1991,6,male,1422.0,846,434,24,40,24,34,0,6,1
1015,52134,1654154,57,28,1956,8,female,130.0,90,47,208,66,208,52,0,14,0
1016,87581,1514091,15,31,1998,12,female,293.0,392,286,54,0,35,0,19,0,0
1017,78513,1507422,25,26,1988,2,male,468.0,246,155,14,18,14,9,0,9,0
1018,96714,1723795,17,5,1996,12,female,402.0,1010,139,630,155,429,93,201,62,1
1019,12163,1721659,49,1,1964,2,male,257.0,12,7,1195,87,1195,73,0,14,1
1020,9760,1743655,33,15,1980,3,male,470.0,9,5,0,3,0,1,0,2,0
1021,91316,1809629,23,29,1990,10,male,560.0,522,301,16,279,16,75,0,204,0
1022,40913,1912989,76,2,1937,8,female,1637.0,60,51,174,111,0,39,174,72,0
1023,73157,1356371,18,8,1995,8,female,330.0,203,141,0,0,0,0,0,0,0
1024,7293,1239723,14,11,1999,11,male,244.0,6,4,0,0,0,0,0,0,1
1025,62737,1443716,18,5,1995,7,male,311.0,133,82,23,7,23,5,0,2,1
1026,59874,1033243,29,22,1984,5,female,324.0,117,60,39,20,18,8,21,12,1
1027,59912,1455180,101,23,1912,2,female,2425.0,118,63,52,12,52,8,0,4,0
1028,92713,2042164,60,29,1953,12,female,404.0,580,505,245,22,241,18,4,4,0
1029,68566,2161269,103,8,1910,1,male,1754.0,164,81,9,0,9,0,0,0,0
1030,25111,1551456,31,14,1982,11,female,736.0,31,8,157,57,157,43,0,14,0
1031,42824,2066572,41,4,1972,11,male,300.0,66,58,5,31,1,8,4,23,0
1032,22677,1900365,33,17,1980,11,male,361.0,28,10,1,0,1,0,0,0,0
1033,5172,1613839,32,25,1981,7,male,113.0,3,3,0,0,0,0,0,0,1
1034,98011,1103619,20,30,1993,12,female,669.0,3056,2184,0,578,0,515,0,63,1
1035,44224,1226956,85,25,1928,12,female,2372.0,67,50,864,385,0,185,864,200,1
1036,68143,2106086,21,30,1992,4,female,218.0,161,119,721,711,393,549,328,162,0
1037,44498,2073019,55,11,1958,1,female,1328.0,69,15,3,1,0,0,3,1,1
1038,19118,1379058,68,16,1945,9,male,990.0,22,8,5,2,0,0,5,2,1
1039,55166,1414624,67,9,1946,7,female,347.0,100,54,307,24,304,17,3,7,0
1040,88661,1586431,103,1,1910,10,male,875.0,418,293,99,165,1,36,98,129,0
1041,78593,1539630,17,19,1996,7,female,243.0,248,188,29,80,25,14,4,66,0
1042,93666,1888740,14,31,1999,8,female,268.0,662,315,222,47,48,20,174,27,0
1043,84477,1991505,18,24,1995,3,male,607.0,322,144,20,119,1,42,19,77,0
1044,66600,1668972,103,2,1910,2,male,792.0,152,105,9,9,2,7,7,2,1
1045,74493,1041192,26,3,1987,5,male,515.0,208,179,13,4,0,3,13,1,0
1046,74352,1455341,23,3,1990,12,male,840.0,208,142,4,2,1,1,3,1,0
1047,67167,1660165,18,31,1995,5,female,297.0,154,114,442,76,442,75,0,1,1
1048,82835,1027913,19,23,1994,10,male,245.0,294,270,178,86,178,50,0,36,1
1049,73295,1684728,26,14,1987,6,female,180.0,200,53,1,5,1,3,0,2,1
1050,8391,1560346,22,8,1991,5,female,334.0,7,5,8,1,8,0,0,1,0
1051,52850,2135146,63,21,1950,10,female,1714.0,93,45,41,93,17,46,24,47,1
1052,17214,2000265,20,4,1993,7,female,330.0,19,8,9,13,9,7,0,6,1
1053,22613,1692552,58,5,1955,11,male,1034.0,28,21,0,0,0,0,0,0,0
1054,25053,1153412,50,11,1963,8,female,1460.0,31,14,60,0,54,0,6,0,0
1055,53796,1518762,25,4,1988,11,female,483.0,95,35,20,17,20,14,0,3,0
1056,64635,1924254,27,27,1986,7,male,632.0,144,71,12,23,12,21,0,2,0
1057,19863,1285224,31,23,1982,2,male,274.0,24,9,0,1,0,0,0,1,0
1058,96203,2000695,16,30,1997,11,female,410.0,1004,804,15,27,15,22,0,5,1
1059,31997,2157965,64,5,1949,3,female,216.0,42,31,18,1,0,0,18,1,0
1060,68104,1940613,57,7,1956,5,female,341.0,160,101,459,32,459,22,0,10,1
1061,6266,1283378,61,28,1952,6,male,759.0,4,2,2,1,0,1,2,0,0
1062,4120,2101552,30,20,1983,8,male,39.0,2,1,0,0,0,0,0,0,1
1063,65120,1736765,58,9,1955,3,female,557.0,143,90,1207,415,0,187,1207,228,1
1064,77413,1009250,18,14,1995,2,female,306.0,237,38,6,7,6,1,0,6,1
1065,77323,1990884,18,29,1995,12,female,508.0,237,169,2,5,2,2,0,3,1
1066,55911,1886814,28,26,1985,7,male,288.0,103,78,35,2,32,0,3,2,0
1067,81094,1752119,54,18,1959,10,female,773.0,262,142,3103,3749,1691,2871,1412,878,0
1068,87059,1219737,108,26,1905,9,male,299.0,369,267,1094,146,1065,64,29,82,1
1069,71065,1979686,45,29,1968,7,male,557.0,177,143,627,1064,86,832,541,232,0
1070,36786,1135234,108,7,1905,12,female,1436.0,53,19,2,2,2,0,0,2,0
1071,68699,1728537,20,3,1993,3,male,1441.0,167,41,24,42,4,8,20,34,1
1072,59591,1983728,22,22,1991,8,female,462.0,116,71,6,40,6,29,0,11,1
1073,84484,1178343,20,28,1993,7,male,530.0,335,218,21,1,0,0,21,1,1
1074,34796,1910009,30,14,1983,5,male,65.0,48,9,2,1,2,0,0,1,0
1075,59264,1198585,21,16,1992,9,male,800.0,117,48,0,2,0,0,0,2,1
1076,9789,1409360,36,23,1977,12,male,36.0,9,8,0,0,0,0,0,0,0
1077,72552,1195366,22,17,1991,8,male,572.0,195,116,13,4,13,2,0,2,1
1078,2252,1061952,22,16,1991,6,male,267.0,1,1,0,0,0,0,0,0,0
1079,8969,1980203,56,17,1957,7,male,289.0,8,4,0,0,0,0,0,0,0
1080,18283,1442122,40,14,1973,9,female,338.0,21,9,51,47,44,36,7,11,0
1081,45446,1218235,42,14,1971,9,male,1593.0,73,19,2,5,2,5,0,0,1
1082,72151,1676413,54,8,1959,5,female,1243.0,189,84,1254,800,7,243,1247,557,1
1083,28162,1170903,42,3,1971,12,female,458.0,36,23,51,27,0,15,51,12,0
1084,57610,2151244,34,25,1979,1,male,427.0,109,30,9,31,9,20,0,11,0
1085,48848,1458771,72,19,1941,12,male,1927.0,80,34,25,4,25,3,0,1,1
1086,5692,1482608,33,17,1980,10,female,300.0,3,3,25,1,17,0,8,1,1
1087,86694,1623057,21,3,1992,2,female,272.0,365,108,96,326,80,196,16,130,0
1088,57982,1938221,31,19,1982,11,male,525.0,109,43,110,16,110,11,0,5,0
1089,78254,1207284,103,15,1910,12,female,907.0,241,121,0,13,0,3,0,10,1
1090,43145,1958967,32,19,1981,2,female,411.0,66,46,53,3,53,2,0,1,0
1091,94550,2115278,18,4,1995,4,female,761.0,733,310,136,45,136,37,0,8,1
1092,44075,2031180,47,21,1966,6,male,955.0,67,23,90,84,90,72,0,12,1
1093,53880,1134111,50,16,1963,10,male,1696.0,94,65,31,8,0,2,31,6,1
1094,27110,1197619,61,10,1952,3,female,214.0,34,20,5,2,5,2,0,0,1
1095,93637,1063197,19,9,1994,7,male,507.0,652,403,186,133,143,74,43,59,0
1096,18782,1922444,108,1,1905,4,male,2009.0,23,8,0,0,0,0,0,0,1
1097,17696,1964820,18,1,1995,1,male,84.0,21,19,0,0,0,0,0,0,1
1098,90977,1692822,16,6,1997,2,female,533.0,495,161,1081,453,1081,436,0,17,0
1099,74114,1518823,18,3,1995,12,male,543.0,206,143,0,1,0,1,0,0,0
1100,86942,1025440,38,25,1975,9,female,2327.0,365,148,428,515,416,416,12,99,0
1101,74206,1007427,56,12,1957,6,female,187.0,209,100,0,1,0,1,0,0,1
1102,98674,1239973,17,26,1996,4,female,936.0,4417,1781,910,1851,548,610,362,1241,1
1103,94946,1164305,16,7,1997,9,female,238.0,760,188,1404,1194,1237,637,167,557,1
1104,77463,1788316,21,18,1992,4,female,336.0,234,33,9,37,9,18,0,19,0
1105,14456,1240256,29,13,1984,6,male,484.0,17,14,0,0,0,0,0,0,1
1106,91615,1980781,16,9,1997,12,female,406.0,563,291,137,187,37,77,100,110,1
1107,40758,2131433,17,10,1996,1,male,411.0,60,45,51,20,50,12,1,8,1
1108,90072,1860425,33,18,1980,8,female,401.0,447,179,2413,1287,2413,1211,0,76,1
1109,30653,2100137,41,24,1972,6,female,548.0,41,22,6,3,1,1,5,2,0
1110,97343,1560856,108,7,1905,2,female,1131.0,1772,72,88,472,88,379,0,93,1
1111,8809,1138057,25,1,1988,1,male,130.0,8,6,0,0,0,0,0,0,0
1112,69787,1462827,18,11,1995,9,female,182.0,175,40,51,89,51,81,0,8,1
1113,46571,1878031,23,1,1990,2,female,397.0,74,50,1,1,1,1,0,0,0
1114,15956,1610105,23,4,1990,3,male,11.0,18,17,3,3,0,1,3,2,0
1115,35721,2022497,62,14,1951,3,male,297.0,50,43,1,0,1,0,0,0,0
1116,65399,1892408,21,24,1992,4,male,710.0,149,121,2,16,1,7,1,9,0
1117,37782,1137016,37,5,1976,5,male,528.0,55,48,5,18,5,10,0,8,1
1118,73226,1854554,30,13,1983,8,male,273.0,203,84,0,9,0,7,0,2,1
1119,10244,2113476,24,30,1989,8,male,94.0,10,7,2,4,0,4,2,0,0
1120,39523,1474298,28,14,1985,11,female,198.0,58,7,2,4,2,4,0,0,1
1121,67411,1635966,22,4,1991,4,male,532.0,162,125,1,2,1,1,0,1,1
1122,3483,1041800,27,10,1986,12,male,355.0,1,1,5,1,2,1,3,0,1
1123,85093,1850299,14,2,1999,10,male,84.0,344,317,0,1,0,0,0,1,1
1124,20746,1381172,33,12,1980,6,female,187.0,25,16,1,0,1,0,0,0,1
1125,68992,1330262,57,14,1956,10,female,869.0,169,103,152,97,142,73,10,24,0
1126,50135,1365127,27,21,1986,11,male,446.0,83,22,131,101,131,87,0,14,1
1127,81871,1921483,108,16,1905,3,female,2192.0,287,103,224,189,222,156,2,33,1
1128,86305,1492927,27,6,1986,9,male,1301.0,379,140,5,14,2,10,3,4,0
1129,73496,1262302,20,21,1993,8,male,1509.0,202,103,14,5,4,0,10,5,1
1130,28822,1799622,71,18,1942,3,male,657.0,38,7,3,2,3,2,0,0,0
1131,47875,1434523,20,15,1993,1,female,310.0,77,55,13,0,13,0,0,0,0
1132,43906,1115311,51,20,1962,1,male,289.0,68,51,26,41,26,28,0,13,0
1133,97624,1589128,108,18,1905,10,male,1578.0,1403,921,486,276,50,79,436,197,1
1134,3556,2146401,26,18,1987,2,male,513.0,1,1,9,0,0,0,9,0,0
1135,66759,1333340,16,6,1997,1,male,616.0,152,101,31,7,7,1,24,6,0
1136,44238,1152052,65,31,1948,7,female,890.0,68,47,1708,815,171,126,1537,689,0
1137,54549,1882886,23,15,1990,2,female,404.0,99,82,2,17,0,7,2,10,0
1138,50635,2180963,42,25,1971,12,male,739.0,87,36,3,8,3,6,0,2,1
1139,66394,1453003,22,25,1991,3,male,397.0,152,86,1,0,1,0,0,0,1
1140,22577,1903536,35,1,1978,1,male,554.0,28,23,0,0,0,0,0,0,1
1141,61491,2055768,58,2,1955,2,female,1692.0,126,34,4,20,4,6,0,14,1
1142,94480,1910683,77,18,1936,6,male,1303.0,732,607,94,181,56,87,38,94,1
1143,16270,1483167,58,2,1955,8,female,1178.0,18,12,195,27,195,20,0,7,0
1144,86116,1596412,64,5,1949,8,female,645.0,347,255,5084,5348,3529,2879,1555,2469,0
1145,9204,2052212,16,30,1997,1,male,22.0,8,6,5,0,5,0,0,0,1
1146,12826,2078741,60,4,1953,4,female,1192.0,13,6,1,4,1,4,0,0,0
1147,87347,1906606,43,11,1970,4,male,607.0,382,279,8,2,5,0,3,2,0
1148,97544,1484839,20,6,1993,11,female,1434.0,1273,456,331,126,301,81,30,45,0
1149,82554,2076976,19,20,1994,3,male,331.0,291,121,32,14,31,12,1,2,0
1150,30770,2069680,67,23,1946,11,male,1266.0,41,17,12,1,0,1,12,0,1
1151,7691,2153034,35,5,1978,6,male,559.0,6,1,0,0,0,0,0,0,1
1152,81174,1185595,36,3,1977,6,male,191.0,287,270,0,1,0,0,0,1,0
1153,52021,1899230,58,1,1955,12,male,478.0,88,30,87,39,0,12,87,27,0
1154,56165,2068081,20,6,1993,6,male,224.0,104,40,184,4,174,3,10,1,1
1155,76410,2165294,18,1,1995,2,female,202.0,222,106,5,38,1,12,4,26,1
1156,29983,1163363,21,9,1992,6,female,153.0,39,19,74,44,74,35,0,9,1
1157,27190,1501096,65,11,1948,9,male,1391.0,34,6,8,3,7,2,1,1,1
1158,78099,1684618,66,1,1947,7,female,670.0,240,161,754,932,260,604,494,328,0
1159,10369,2109855,17,1,1996,10,male,208.0,9,3,4,0,0,0,4,0,0
1160,4170,1107557,33,1,1980,2,male,632.0,2,0,0,0,0,0,0,0,1
1161,28899,2082266,65,5,1948,2,female,563.0,38,33,6,5,0,2,6,3,1
1162,49616,1939752,23,3,1990,1,female,309.0,82,52,3,1,3,1,0,0,1
1163,39927,1424844,81,16,1932,3,female,485.0,58,38,65,22,0,5,65,17,1
1164,31345,2147089,24,16,1989,5,female,123.0,42,31,0,0,0,0,0,0,0
1165,56082,1185275,57,27,1956,3,female,593.0,103,45,111,139,111,91,0,48,1
1166,78641,1934507,113,3,1900,8,female,1533.0,250,102,41,11,0,7,41,4,1
1167,88569,1901052,13,23,2000,1,male,252.0,421,231,58,127,48,68,10,59,1
1168,42438,1525570,21,12,1992,6,female,209.0,64,39,901,443,900,163,1,280,1
1169,25165,1046707,17,30,1996,11,male,646.0,33,23,0,1,0,1,0,0,1
1170,40972,1953795,40,6,1973,9,male,256.0,61,43,312,7,192,5,120,2,1
1171,46091,1218444,31,17,1982,12,male,601.0,73,44,124,0,124,0,0,0,1
1172,87723,1926711,23,2,1990,1,male,250.0,408,328,130,148,130,107,0,41,0
1173,18768,1361825,81,27,1932,6,female,495.0,23,17,0,0,0,0,0,0,1
1174,38183,1309241,50,26,1963,2,female,1694.0,55,23,90,51,77,39,13,12,1
1175,65165,1845350,17,13,1996,1,male,1080.0,146,121,0,0,0,0,0,0,1
1176,92524,1720953,103,14,1910,11,male,706.0,593,287,90,230,90,212,0,18,0
1177,54582,2028342,42,15,1971,10,male,369.0,98,42,3,1,0,0,3,1,1
1178,75826,1993131,28,29,1985,9,female,354.0,214,126,89,309,42,126,47,183,1
1179,94039,2080950,18,12,1995,2,female,237.0,693,343,2872,535,2754,339,118,196,1
1180,59613,1843802,59,29,1954,3,male,1607.0,117,55,7,6,7,4,0,2,1
1181,58886,1044166,93,30,1920,11,male,1740.0,113,59,70,15,70,8,0,7,0
1182,32860,1948264,41,23,1972,3,male,775.0,45,25,5,7,1,4,4,3,0
1183,89384,1405897,38,26,1975,7,male,1018.0,471,217,16,1,3,0,13,1,1
1184,15315,1000957,40,3,1973,3,male,22.0,17,9,26,31,9,21,17,10,0
1185,69897,1173539,20,13,1993,9,female,170.0,170,75,111,108,105,52,6,56,1
1186,36467,2043330,16,12,1997,1,male,34.0,53,50,0,0,0,0,0,0,1
1187,1667,1935473,69,18,1944,10,male,185.0,0,0,0,0,0,0,0,0,1
1188,88350,2079547,16,31,1997,10,female,460.0,439,284,9,7,9,5,0,2,0
1189,75318,1604607,68,6,1945,1,male,474.0,218,107,2,15,2,13,0,2,1
1190,78923,1352000,18,23,1995,7,male,452.0,244,165,283,126,283,120,0,6,0
1191,20620,1926355,35,25,1978,12,male,150.0,25,19,0,3,0,1,0,2,1
1192,85738,1780764,18,27,1995,11,male,479.0,345,244,112,41,104,36,8,5,0
1193,77381,1025993,27,2,1986,10,female,381.0,236,118,4,29,4,22,0,7,0
1194,64585,1804619,37,14,1976,1,female,473.0,142,116,9,10,0,8,9,2,0
1195,58932,2041883,52,20,1961,3,male,1603.0,115,58,94,27,94,20,0,7,1
1196,12839,1320085,51,1,1962,6,female,87.0,13,13,2,0,0,0,2,0,0
1197,75267,1813571,108,25,1905,11,male,764.0,216,133,1,1,1,1,0,0,1
1198,41896,1738492,30,4,1983,2,male,278.0,62,21,20,0,20,0,0,0,1
1199,74697,2137913,40,11,1973,8,male,326.0,210,158,51,18,51,17,0,1,1
1200,46364,1237417,22,26,1991,3,male,407.0,75,55,0,0,0,0,0,0,0
1201,97886,1561449,21,27,1992,5,female,231.0,1682,470,2295,4190,904,1352,1391,2838,0
1202,62184,1273832,18,26,1995,10,male,296.0,129,96,912,39,912,36,0,3,1
1203,72715,1490427,20,27,1993,6,female,231.0,197,65,45,41,43,36,2,5,1
1204,4015,1903828,25,21,1988,5,female,14.0,2,2,0,0,0,0,0,0,0
1205,80802,1196914,58,25,1955,9,female,620.0,265,162,107,29,0,22,107,7,0
1206,22158,1485727,21,24,1992,8,male,19.0,26,20,22,8,22,4,0,4,1
1207,83600,1232041,17,23,1996,6,male,176.0,315,179,46,42,17,20,29,22,1
1208,28005,1346185,25,27,1988,10,female,145.0,36,29,7,4,6,3,1,1,0
1209,69549,1076189,89,29,1924,12,male,2530.0,174,47,9,4,0,0,9,4,1
1210,56643,1255405,73,8,1940,2,male,1569.0,105,21,6,2,6,0,0,2,1
1211,75957,1319600,36,4,1977,10,male,205.0,216,120,185,13,185,11,0,2,0
1212,52373,2065180,46,21,1967,6,female,349.0,91,52,0,0,0,0,0,0,1
1213,64619,1768975,45,19,1968,10,female,699.0,142,77,11,7,11,5,0,2,0
1214,28700,1092232,54,18,1959,3,male,202.0,37,31,1,7,1,4,0,3,1
1215,83169,1610539,20,27,1993,5,female,570.0,308,139,0,3,0,1,0,2,1
1216,92344,1518588,95,5,1918,1,male,2506.0,616,149,26,10,2,4,24,6,1
1217,31342,1256967,24,15,1989,1,male,360.0,42,27,0,0,0,0,0,0,0
1218,12348,1831143,25,20,1988,2,male,115.0,14,8,0,0,0,0,0,0,1
1219,50834,1368711,23,1,1990,1,male,96.0,85,69,19,3,19,2,0,1,1
1220,9036,1367078,55,30,1958,10,female,3.0,8,8,1,3,0,0,1,3,1
1221,44880,1211019,59,26,1954,3,male,381.0,70,65,72,9,9,4,63,5,1
1222,49701,2182850,30,14,1983,3,female,69.0,82,64,6,24,6,11,0,13,0
1223,68530,1284671,19,5,1994,4,male,110.0,165,149,7,10,7,5,0,5,1
1224,43683,1748818,27,22,1986,3,male,328.0,68,55,3,0,3,0,0,0,1
1225,55697,1591019,113,20,1900,8,female,2480.0,102,17,8,18,8,16,0,2,0
1226,26320,1020965,26,24,1987,10,male,342.0,32,24,92,5,92,5,0,0,0
1227,84130,1511495,16,6,1997,9,male,494.0,329,246,0,5,0,1,0,4,0
1228,50358,1730657,22,14,1991,3,male,336.0,86,40,0,0,0,0,0,0,0
1229,74444,1732053,33,5,1980,2,male,135.0,205,169,9,8,2,1,7,7,0
1230,47615,1079052,63,5,1950,1,male,1440.0,77,17,0,0,0,0,0,0,0
1231,85052,1197798,37,28,1976,4,female,1718.0,334,145,1291,1603,1270,1051,21,552,1
1232,13128,1500747,23,28,1990,7,female,17.0,14,2,7,9,7,8,0,1,1
1233,18478,1951181,23,29,1990,5,female,397.0,22,12,0,5,0,5,0,0,1
1234,81184,1716631,75,3,1938,1,male,1742.0,278,41,0,26,0,17,0,9,1
1235,235,1925696,18,3,1995,6,male,380.0,0,0,0,3,0,3,0,0,0
1236,46220,1131015,62,24,1951,10,male,347.0,71,28,442,65,48,52,394,13,0
1237,84279,1790313,69,22,1944,4,female,119.0,329,133,2,1,2,1,0,0,0
1238,65787,1808943,14,16,1999,12,male,245.0,146,49,38,38,29,22,9,16,1
1239,62943,2001367,45,21,1968,6,female,714.0,131,85,85,76,85,45,0,31,0
1240,15713,1930079,33,6,1980,4,male,54.0,18,13,0,0,0,0,0,0,0
1241,35101,1972464,37,10,1976,1,male,501.0,48,21,23,64,23,40,0,24,0
1242,15398,1391957,63,22,1950,10,female,473.0,16,12,50,2,0,0,50,2,0
1243,32953,1056606,40,10,1973,10,male,237.0,45,16,9,11,9,11,0,0,0
1244,30126,1760879,19,21,1994,6,male,109.0,41,18,0,0,0,0,0,0,0
1245,1593,1081132,58,1,1955,1,male,655.0,0,0,0,0,0,0,0,0,0
1246,25964,1853406,68,5,1945,8,male,121.0,32,27,12,9,1,3,11,6,0
1247,84614,1850093,25,8,1988,7,male,569.0,332,286,49,28,49,24,0,4,1
1248,21808,1817455,35,10,1978,4,female,1001.0,27,9,3,0,3,0,0,0,0
1249,27146,1505112,27,9,1986,8,male,440.0,34,26,7,0,0,0,7,0,1
1250,73104,1284335,35,8,1978,12,female,469.0,191,110,1956,2143,1846,1705,110,438,1
1251,48088,1194333,57,15,1956,3,male,488.0,78,35,93,63,8,22,85,41,0
1252,82326,1192440,19,24,1994,7,female,539.0,300,129,4,1,4,1,0,0,1
1253,8659,1240028,32,1,1981,1,female,284.0,7,4,201,2,176,2,25,0,0
1254,94126,1402608,16,27,1997,7,female,275.0,795,60,1,6,1,6,0,0,1
1255,28896,1746801,39,14,1974,4,male,316.0,38,15,6,1,0,1,6,0,1
1256,52276,1545998,19,5,1994,8,male,426.0,91,53,0,1,0,1,0,0,0
1257,90802,1748710,41,10,1972,5,male,480.0,508,464,279,16,279,14,0,2,0
1258,33478,1977971,19,2,1994,9,male,25.0,46,46,0,0,0,0,0,0,1
1259,14176,1184242,27,15,1986,5,female,78.0,15,9,44,3,44,3,0,0,1
1260,1614,1113155,60,19,1953,7,female,95.0,0,0,0,0,0,0,0,0,1
1261,89661,1044701,108,18,1905,11,female,408.0,459,178,111,128,111,82,0,46,0
1262,39673,1711486,25,24,1988,9,female,198.0,58,37,9,17,9,16,0,1,1
1263,34952,1786312,25,26,1988,3,male,418.0,48,31,8,0,8,0,0,0,1
1264,91994,1761307,67,17,1946,6,female,355.0,539,257,1698,1929,83,487,1615,1442,0
1265,55845,1459138,108,9,1905,3,female,1740.0,102,50,24,139,12,77,12,62,0
1266,855,1854760,28,16,1985,1,male,86.0,0,0,0,0,0,0,0,0,0
1267,83906,1241875,24,12,1989,2,male,762.0,308,248,307,213,307,167,0,46,1
1268,25355,1488272,36,28,1977,4,male,215.0,32,14,0,3,0,3,0,0,0
1269,5221,1468204,38,1,1975,12,female,557.0,3,1,0,0,0,0,0,0,1
1270,1724,1502300,53,23,1960,11,male,93.0,0,0,1,1,0,1,1,0,1
1271,14462,1983459,30,5,1983,2,female,630.0,17,12,0,3,0,1,0,2,1
1272,6824,1577322,49,1,1964,9,male,623.0,5,3,0,0,0,0,0,0,1
1273,69539,1949601,16,1,1997,3,female,434.0,173,54,8,0,8,0,0,0,1
1274,87937,1951151,15,6,1998,10,female,309.0,404,225,502,588,4,76,498,512,1
1275,98636,1405803,25,11,1988,8,male,667.0,3820,2836,835,377,107,106,728,271,0
1276,30375,1131606,15,27,1998,8,female,68.0,41,29,1,0,1,0,0,0,1
1277,96720,2184200,18,26,1995,2,female,242.0,1191,825,612,281,612,264,0,17,0
1278,190,1863042,17,24,1996,9,male,29.0,0,0,0,0,0,0,0,0,1
1279,62253,1738166,20,8,1993,7,female,627.0,134,93,0,0,0,0,0,0,0
1280,17126,1319714,34,10,1979,12,female,231.0,20,12,6,7,6,5,0,2,0
1281,69663,1009701,26,15,1987,1,male,522.0,170,107,22,21,22,3,0,18,1
1282,877,2178700,28,24,1985,5,female,323.0,0,0,0,0,0,0,0,0,0
1283,32935,2151215,73,15,1940,9,female,1165.0,45,22,8,6,8,4,0,2,1
1284,94506,2060838,94,25,1919,9,male,967.0,763,293,105,204,0,93,105,111,0
1285,96511,2118930,22,10,1991,1,male,281.0,1069,997,217,46,217,38,0,8,1
1286,74744,1671739,28,17,1985,6,male,322.0,210,188,68,7,56,5,12,2,0
1287,9055,1405699,28,23,1985,10,male,215.0,8,8,1,0,1,0,0,0,1
1288,94112,1037493,26,18,1987,12,male,1878.0,803,320,1,0,0,0,1,0,0
1289,92968,1010975,29,7,1984,3,male,760.0,631,448,1099,2271,614,1216,485,1055,1
1290,1847,2193232,30,23,1983,11,male,94.0,0,0,3,2,3,2,0,0,0
1291,58211,1193259,19,26,1994,11,male,429.0,112,109,0,0,0,0,0,0,1
1292,54236,1512203,45,20,1968,3,male,397.0,96,69,252,15,19,2,233,13,1
1293,40958,1628463,57,30,1956,6,female,979.0,61,32,248,129,235,71,13,58,1
1294,20115,1800010,19,1,1994,7,male,727.0,24,18,3,8,3,3,0,5,0
1295,21272,1209384,23,15,1990,5,male,421.0,27,21,0,9,0,4,0,5,1
1296,32407,1352513,17,14,1996,11,male,130.0,44,40,0,0,0,0,0,0,0
1297,86700,1399142,63,6,1950,10,male,132.0,377,320,100,44,80,42,20,2,1
1298,87468,1863533,17,3,1996,5,male,602.0,390,290,24,1,24,0,0,1,0
1299,74611,1948500,62,18,1951,5,female,1043.0,211,128,28,80,23,17,5,63,1
1300,10314,1108533,44,5,1969,3,male,747.0,9,5,2,3,2,3,0,0,0
1301,42489,1105521,18,15,1995,6,male,266.0,65,30,0,0,0,0,0,0,0
1302,58340,1743941,19,3,1994,9,male,570.0,113,79,1,6,0,2,1,4,0
1303,14887,2060133,33,28,1980,10,male,91.0,17,4,2,0,2,0,0,0,0
1304,11530,1906421,16,21,1997,2,male,203.0,12,4,0,0,0,0,0,0,1
1305,70390,1598382,23,21,1990,6,male,363.0,179,81,3,0,3,0,0,0,1
1306,66091,2135466,71,10,1942,6,female,1240.0,150,64,267,161,0,17,267,144,1
1307,3551,1017525,34,21,1979,2,male,41.0,1,1,8,32,8,18,0,14,0
1308,24312,1070805,60,19,1953,8,female,93.0,29,15,64,14,0,5,64,9,0
1309,86960,1152335,14,18,1999,3,female,519.0,373,210,464,417,464,374,0,43,1
1310,26604,1133801,28,12,1985,8,male,297.0,35,28,0,0,0,0,0,0,0
1311,78008,1725497,29,27,1984,12,male,214.0,237,153,346,46,346,34,0,12,0
1312,91976,1938318,27,1,1986,8,male,755.0,537,340,1182,351,1153,94,29,257,0
1313,60257,1476663,18,6,1995,3,male,844.0,116,86,1387,1323,1311,948,76,375,0
1314,6391,1953958,53,6,1960,3,male,649.0,4,3,9,6,1,1,8,5,1
1315,21778,2065499,14,1,1999,3,male,121.0,27,21,3,1,0,0,3,1,0
1316,12417,2123339,29,16,1984,8,male,117.0,14,6,0,1,0,1,0,0,1
1317,71699,1226106,18,29,1995,8,male,458.0,188,107,39,100,39,35,0,65,0
1318,7599,1360745,29,8,1984,4,female,258.0,6,3,0,0,0,0,0,0,0
1319,31361,1737985,26,1,1987,1,male,301.0,42,23,0,0,0,0,0,0,0
1320,51677,1244996,61,4,1952,8,female,457.0,89,71,8,5,0,0,8,5,1
1321,66352,1623211,35,24,1978,7,male,1029.0,156,56,0,6,0,1,0,5,0
1322,60894,1306109,30,20,1983,11,female,485.0,124,99,74,157,53,108,21,49,1
1323,83037,2187895,21,4,1992,4,female,296.0,301,102,692,647,691,376,1,271,1
1324,5725,1519476,28,3,1985,3,male,177.0,3,3,73,14,73,14,0,0,1
1325,67223,1670852,34,21,1979,6,female,794.0,155,76,1496,547,1496,499,0,48,0
1326,45987,1392438,52,11,1961,2,female,1164.0,72,38,61,8,61,6,0,2,0
1327,17859,1582967,59,21,1954,10,female,515.0,21,20,0,0,0,0,0,0,0
1328,84082,1074222,14,4,1999,1,male,35.0,319,243,1275,1072,559,751,716,321,1
1329,41766,1720959,28,24,1985,10,male,397.0,64,38,10,41,10,33,0,8,0
1330,62007,1300422,32,11,1981,5,male,429.0,126,48,152,33,152,24,0,9,1
1331,92462,1382885,22,5,1991,10,female,419.0,626,432,56,370,56,324,0,46,0
1332,18306,2065402,25,12,1988,6,male,100.0,21,15,75,0,75,0,0,0,1
1333,24906,2039520,60,24,1953,12,female,458.0,31,14,12,20,3,13,9,7,0
1334,2979,1959274,48,16,1965,3,male,618.0,1,1,0,1,0,0,0,1,1
1335,25710,1056113,32,6,1981,4,male,636.0,32,16,3,0,3,0,0,0,0
1336,33470,1783010,19,24,1994,2,male,865.0,46,4,0,2,0,2,0,0,1
1337,90183,2064239,18,17,1995,1,male,419.0,486,359,1,2,1,0,0,2,1
1338,67407,1366006,15,1,1998,6,male,272.0,162,96,1,4,1,3,0,1,1
1339,80719,1304968,24,21,1989,4,male,974.0,273,177,66,21,66,9,0,12,1
1340,42979,1375243,23,7,1990,10,male,122.0,66,44,17,5,4,3,13,2,0
1341,47147,1361776,60,11,1953,1,female,677.0,74,48,52,33,0,24,52,9,0
1342,96702,2043317,17,17,1996,7,female,383.0,1128,750,582,1562,575,1276,7,286,0
1343,74289,1479425,21,10,1992,10,male,525.0,211,121,2,0,2,0,0,0,0
1344,43805,1726599,22,26,1991,3,male,369.0,67,54,11,6,11,6,0,0,0
1345,90029,1223127,19,21,1994,7,male,202.0,443,288,1174,124,1174,106,0,18,1
1346,54036,1812257,20,17,1993,1,male,15.0,94,59,70,38,35,8,35,30,0
1347,49661,1014110,40,29,1973,9,male,515.0,82,60,5,2,0,0,5,2,1
1348,46386,1478355,24,23,1989,3,male,250.0,76,70,0,0,0,0,0,0,1
1349,72840,1221949,31,31,1982,3,male,944.0,197,149,106,25,21,17,85,8,0
1350,93223,1465136,60,3,1953,6,female,357.0,640,131,7,384,0,42,7,342,1
1351,13017,2010140,18,11,1995,2,male,307.0,13,12,4,0,4,0,0,0,0
1352,18203,1497251,17,11,1996,8,female,46.0,21,17,19,36,19,23,0,13,0
1353,9440,1949930,16,26,1997,6,male,152.0,9,7,0,0,0,0,0,0,1
1354,77761,1698133,14,8,1999,6,female,264.0,238,117,80,125,14,36,66,89,1
1355,51510,1183147,30,27,1983,6,male,357.0,88,85,2,0,2,0,0,0,0
1356,24753,2161361,20,20,1993,5,male,315.0,31,21,2,0,2,0,0,0,1
1357,45842,1413373,26,5,1987,5,male,321.0,72,64,29,65,2,28,27,37,0
1358,84762,1798344,23,8,1990,5,male,508.0,334,216,130,118,130,109,0,9,0
1359,94625,1346221,25,4,1988,3,male,628.0,759,452,196,74,196,70,0,4,1
1360,63370,1616654,65,11,1948,7,male,307.0,135,134,0,0,0,0,0,0,1
1361,56805,1763065,89,18,1924,10,male,1240.0,107,41,26,26,6,17,20,9,1
1362,78616,1514626,23,1,1990,1,male,470.0,250,170,34,65,34,49,0,16,0
1363,33016,1654185,43,13,1970,3,male,66.0,44,33,14,2,14,0,0,2,1
1364,67132,1504095,20,23,1993,1,female,1010.0,151,97,324,62,313,32,11,30,1
1365,36995,2174833,29,25,1984,11,male,348.0,53,33,10,0,10,0,0,0,0
1366,59079,1670366,52,10,1961,11,female,505.0,114,97,304,44,304,44,0,0,1
1367,72145,1354038,23,14,1990,8,female,641.0,185,59,1038,46,1038,41,0,5,1
1368,63879,1526119,46,19,1967,1,male,1411.0,138,54,54,170,27,37,27,133,0
1369,76590,1004605,59,17,1954,2,female,288.0,226,173,23,208,0,48,23,160,1
1370,67705,1589457,37,27,1976,12,male,212.0,158,102,27,2,0,0,27,2,1
1371,91661,1036015,42,4,1971,12,male,940.0,555,261,179,136,179,54,0,82,0
1372,25194,1675185,18,27,1995,9,male,111.0,32,28,0,6,0,3,0,3,1
1373,18357,1346990,46,8,1967,12,female,311.0,21,7,305,14,305,12,0,2,0
1374,2205,1629587,21,11,1992,2,male,216.0,1,1,0,0,0,0,0,0,0
1375,96349,1256090,19,18,1994,6,female,690.0,1155,403,76,660,51,158,25,502,1
1376,15139,1772792,39,8,1974,7,male,257.0,16,11,8,15,8,14,0,1,1
1377,41189,1184020,27,17,1986,10,male,147.0,64,58,0,0,0,0,0,0,0
1378,39379,1455455,56,7,1957,6,male,574.0,59,33,0,0,0,0,0,0,0
1379,21492,1079777,59,29,1954,4,male,346.0,27,24,0,0,0,0,0,0,1
1380,29800,1198861,29,9,1984,11,female,747.0,39,11,8,7,8,5,0,2,1
1381,65430,1511361,96,6,1917,2,male,868.0,146,130,2,16,2,14,0,2,1
1382,12999,1204337,74,29,1939,11,female,1593.0,13,4,4,2,0,0,4,2,0
1383,55618,1432520,56,21,1957,11,male,232.0,102,57,5,34,0,8,5,26,0
1384,45662,1824931,103,20,1910,8,male,945.0,71,43,10,18,10,12,0,6,1
1385,63511,1698044,24,13,1989,3,male,106.0,138,120,3,49,3,5,0,44,1
1386,28975,2010285,62,15,1951,7,male,75.0,38,30,9,0,7,0,2,0,1
1387,37516,1106176,30,15,1983,11,male,260.0,55,26,0,6,0,6,0,0,1
1388,10928,1315262,26,1,1987,1,male,199.0,11,7,0,1,0,0,0,1,1
1389,49126,2077990,19,23,1994,7,male,152.0,79,64,169,13,139,8,30,5,1
1390,2560,2022283,28,3,1985,9,male,20.0,1,1,0,0,0,0,0,0,1
1391,92630,2187935,108,25,1905,1,male,1885.0,607,188,158,128,148,77,10,51,1
1392,18432,1288788,19,16,1994,7,female,338.0,23,5,0,1,0,0,0,1,0
1393,17419,1131820,34,13,1979,10,male,488.0,19,14,29,2,29,1,0,1,1
1394,61262,1522904,30,21,1983,3,female,289.0,125,92,0,0,0,0,0,0,1
1395,80137,1707398,19,24,1994,3,female,64.0,266,243,0,7,0,5,0,2,1
1396,82348,1555308,22,22,1991,11,male,557.0,303,230,5,11,5,5,0,6,0
1397,48689,1425075,43,15,1970,7,male,180.0,79,69,9,0,9,0,0,0,0
1398,93796,1078334,32,25,1981,5,male,605.0,671,554,449,35,448,24,1,11,0
1399,14378,1981369,23,12,1990,10,male,461.0,16,7,0,0,0,0,0,0,1
1400,31885,1572694,35,14,1978,3,male,325.0,42,28,9,1,0,0,9,1,1
1401,84827,1543191,19,21,1994,4,female,273.0,325,190,209,578,128,296,81,282,1
1402,37718,1442807,109,4,1904,5,female,1723.0,55,5,3,0,3,0,0,0,1
1403,67448,1020038,17,5,1996,6,female,76.0,162,117,2,7,2,6,0,1,1
1404,85474,2092642,22,17,1991,4,male,158.0,340,286,22,76,22,73,0,3,0
1405,9843,1340994,41,5,1972,5,male,14.0,10,7,0,0,0,0,0,0,1
1406,54133,1619408,61,14,1952,4,female,714.0,96,53,121,52,0,24,121,28,1
1407,74020,1181483,26,24,1987,3,female,482.0,204,95,614,45,614,27,0,18,1
1408,59324,2105795,31,27,1982,8,male,185.0,116,107,0,1,0,0,0,1,0
1409,35686,1250066,70,20,1943,2,male,1152.0,51,24,1,1,0,1,1,0,0
1410,91222,1536730,74,11,1939,11,male,1938.0,551,418,4,135,0,115,4,20,0
1411,31784,1236288,26,13,1987,2,male,410.0,43,29,5,3,0,1,5,2,1
1412,26564,1749058,25,12,1988,6,male,317.0,34,28,0,3,0,2,0,1,1
1413,29718,1995120,26,28,1987,9,female,303.0,39,25,3,7,1,3,2,4,0
1414,43539,1593957,56,18,1957,2,male,1031.0,67,33,0,2,0,0,0,2,0
1415,90338,1816036,16,29,1997,3,female,232.0,504,387,16,0,16,0,0,0,0
1416,13132,1233050,15,13,1998,1,male,49.0,14,13,8,0,1,0,7,0,0
1417,44694,1783022,21,7,1992,9,female,165.0,69,44,13,8,13,7,0,1,0
1418,6913,1840530,33,25,1980,6,male,999.0,5,4,1,0,0,0,1,0,0
1419,10708,1311708,14,19,1999,7,male,14.0,9,8,37,26,37,11,0,15,1
1420,16689,1055674,70,27,1943,12,male,815.0,20,10,0,0,0,0,0,0,1
1421,38842,1319589,38,5,1975,8,female,225.0,56,35,18,5,18,0,0,5,0
1422,89539,2051648,20,5,1993,8,female,263.0,443,307,48,24,48,21,0,3,1
1423,37849,1140627,62,21,1951,7,female,422.0,54,45,10,24,0,4,10,20,1
1424,14143,1031093,29,1,1984,1,male,278.0,15,7,28,6,28,5,0,1,0
1425,63470,1196367,22,14,1991,8,male,363.0,137,117,2,0,2,0,0,0,0
1426,34073,1966920,23,30,1990,1,female,260.0,46,21,16,66,11,35,5,31,1
1427,2655,1478128,31,5,1982,7,female,95.0,1,1,0,0,0,0,0,0,1
1428,71615,1725332,103,18,1910,7,female,1273.0,187,112,24,125,24,113,0,12,1
1429,29377,1727174,58,25,1955,10,female,883.0,38,19,148,39,148,33,0,6,1
1430,82373,1452385,24,16,1989,8,female,631.0,295,149,7,17,2,7,5,10,1
1431,13189,1793751,34,5,1979,12,male,37.0,13,9,10,10,10,10,0,0,1
1432,66822,2000308,25,25,1988,7,male,269.0,156,108,47,6,47,5,0,1,1
1433,20900,1625542,73,15,1940,5,male,360.0,25,22,8,4,8,4,0,0,0
1434,53735,1748112,65,20,1948,6,female,1215.0,96,21,14,52,14,42,0,10,0
1435,8174,2057239,38,26,1975,3,male,375.0,6,5,2,1,2,1,0,0,0
1436,13321,2065355,25,23,1988,6,female,504.0,13,8,23,2,17,2,6,0,1
1437,82891,2039908,19,22,1994,9,female,437.0,294,201,234,153,199,118,35,35,0
1438,60034,1718519,38,14,1975,1,female,1050.0,117,87,122,96,120,67,2,29,0
1439,63862,1394061,21,8,1992,8,female,337.0,135,76,49,65,49,54,0,11,0
1440,72844,1125650,15,8,1998,12,female,277.0,196,142,106,39,106,13,0,26,0
1441,70782,1949670,40,1,1973,7,female,316.0,182,162,60,29,60,26,0,3,0
1442,1044,1392371,32,1,1981,1,male,147.0,0,0,0,0,0,0,0,0,0
1443,91447,1670056,20,31,1993,8,male,605.0,520,481,47,41,16,30,31,11,0
1444,87286,1538899,25,16,1988,12,male,234.0,399,394,4,0,4,0,0,0,0
1445,91118,1634213,34,18,1979,5,male,1063.0,540,303,0,1,0,1,0,0,0
1446,28013,1570085,17,16,1996,4,male,42.0,36,29,7,13,7,7,0,6,0
1447,38549,1564860,23,5,1990,1,female,70.0,56,27,1,2,1,2,0,0,0
1448,60380,1875237,38,16,1975,9,male,290.0,124,68,0,1,0,0,0,1,1
1449,81812,1716946,22,27,1991,6,female,561.0,284,51,154,256,138,81,16,175,1
1450,95656,2123961,22,26,1991,9,female,613.0,911,718,347,491,268,283,79,208,0
1451,14712,1432650,37,2,1976,6,male,175.0,17,6,1,0,0,0,1,0,1
1452,93708,2101088,30,13,1983,7,male,628.0,690,429,288,144,288,137,0,7,0
1453,33057,1614290,69,19,1944,12,female,1396.0,45,25,19,0,0,0,19,0,1
1454,89951,1323326,13,8,2000,2,female,318.0,475,308,618,457,342,86,276,371,0
1455,21188,1730987,16,1,1997,2,male,207.0,27,25,0,3,0,3,0,0,1
1456,19332,1400908,71,11,1942,8,female,406.0,23,13,13,0,12,0,1,0,1
1457,65961,1664680,35,1,1978,9,female,176.0,149,134,106,87,106,61,0,26,0
1458,7729,1611986,38,14,1975,5,male,23.0,6,6,0,1,0,1,0,0,1
1459,37406,1724137,100,13,1913,9,female,251.0,52,40,886,332,886,270,0,62,1
1460,69063,2185703,101,19,1912,9,male,737.0,163,102,279,59,0,32,279,27,1
1461,80337,1859469,15,1,1998,12,male,404.0,265,143,5,3,5,3,0,0,0
1462,37589,2180019,81,17,1932,4,male,1093.0,54,25,0,0,0,0,0,0,1
1463,46795,1838700,73,14,1940,2,female,270.0,74,48,6,17,0,1,6,16,0
1464,71813,1621292,26,29,1987,12,female,469.0,189,126,75,57,63,33,12,24,1
1465,59186,1619940,23,8,1990,9,female,310.0,115,38,5635,354,5635,237,0,117,1
1466,69723,1654703,31,22,1982,10,male,283.0,175,119,32,12,32,10,0,2,0
1467,87905,1221929,86,12,1927,10,female,2315.0,382,180,383,231,350,195,33,36,0
1468,91787,2096213,20,7,1993,12,male,137.0,537,451,352,964,308,357,44,607,1
1469,14676,1552323,66,26,1947,2,female,648.0,16,9,0,0,0,0,0,0,1
1470,90789,2129686,49,29,1964,7,male,617.0,478,413,270,134,269,71,1,63,0
1471,36487,1499680,20,12,1993,11,male,753.0,53,25,0,0,0,0,0,0,0
1472,69759,2134857,21,30,1992,5,male,220.0,174,139,41,5,41,5,0,0,1
1473,39332,1234827,31,18,1982,5,male,627.0,59,51,0,0,0,0,0,0,1
1474,40617,1732617,31,21,1982,2,male,384.0,61,37,16,7,16,4,0,3,1
1475,27609,2042071,25,20,1988,5,male,147.0,34,31,184,4,184,3,0,1,1
1476,18117,1146254,57,7,1956,9,male,615.0,21,11,9,16,4,9,5,7,1
1477,21868,2039156,25,1,1988,1,male,66.0,27,25,4,6,4,4,0,2,1
1478,76284,1139183,20,9,1993,4,female,418.0,222,198,1,0,1,0,0,0,0
1479,36973,1506524,70,12,1943,9,female,915.0,53,17,9,36,0,10,9,26,0
1480,20388,1441352,49,9,1964,6,male,2074.0,24,10,41,12,41,5,0,7,1
1481,53608,1029698,46,7,1967,4,male,412.0,95,72,7,2,7,2,0,0,1
1482,76958,1306377,108,27,1905,5,female,1367.0,222,159,270,62,5,43,265,19,1
1483,68920,1387710,26,20,1987,3,female,77.0,169,116,98,78,12,65,86,13,0
1484,63045,1863926,18,9,1995,12,female,131.0,130,98,177,34,177,20,0,14,1
1485,24007,1262696,50,20,1963,9,male,1554.0,29,10,12,21,12,21,0,0,0
1486,79724,1580574,21,11,1992,10,male,359.0,255,214,80,172,80,139,0,33,0
1487,50589,1505754,18,1,1995,9,male,434.0,85,70,2,18,2,10,0,8,1
1488,10336,1286812,53,19,1960,8,female,1374.0,9,6,3,9,0,2,3,7,0
1489,6014,1844896,34,5,1979,8,male,213.0,4,4,0,0,0,0,0,0,0
1490,88560,1207917,31,25,1982,6,male,424.0,431,265,51,51,51,19,0,32,1
1491,45158,1949751,23,4,1990,1,male,515.0,71,33,0,0,0,0,0,0,1
1492,10643,1867532,24,10,1989,12,male,132.0,9,4,20,9,20,9,0,0,1
1493,90360,1186722,20,27,1993,9,female,775.0,494,168,20,14,17,12,3,2,1
1494,29320,1916676,28,7,1985,3,female,178.0,37,30,88,137,23,107,65,30,0
1495,74077,1226930,18,29,1995,4,female,440.0,203,89,2169,647,2044,316,125,331,0
1496,79835,1250476,18,4,1995,11,male,444.0,253,193,165,2,5,2,160,0,0
1497,36168,1285180,27,14,1986,2,male,248.0,50,32,40,29,0,16,40,13,1
1498,10523,2149230,25,14,1988,4,male,37.0,9,6,9,5,9,4,0,1,1
1499,83570,1331769,15,8,1998,1,female,554.0,309,227,38,0,3,0,35,0,0
1500,43376,2170219,34,12,1979,3,female,619.0,66,47,1276,798,685,527,591,271,0
1501,93383,1571114,108,31,1905,8,male,2248.0,701,300,40,211,35,123,5,88,0
1502,13879,2000532,49,5,1964,5,male,21.0,15,15,1,2,1,2,0,0,0
1503,78657,1629098,108,29,1905,8,female,989.0,244,109,43,5,43,1,0,4,1
1504,88270,1413560,20,1,1993,1,male,821.0,423,144,3,11,3,8,0,3,0
1505,23196,2151879,21,13,1992,2,male,182.0,29,20,0,0,0,0,0,0,1
1506,25828,1151060,46,3,1967,8,male,501.0,33,27,6,0,6,0,0,0,1
1507,7866,1293092,54,14,1959,1,male,187.0,6,5,0,0,0,0,0,0,0
1508,9004,1863991,108,26,1905,11,male,47.0,8,8,0,0,0,0,0,0,1
1509,51322,1288333,20,24,1993,8,female,545.0,90,60,0,1,0,0,0,1,0
1510,40900,1640435,18,25,1995,11,male,40.0,61,54,138,101,138,66,0,35,1
1511,23557,1252903,56,14,1957,5,male,726.0,29,9,1,15,0,11,1,4,0
1512,90154,1985589,68,20,1945,1,male,293.0,495,263,0,0,0,0,0,0,1
1513,35951,2151233,63,26,1950,9,female,697.0,51,35,9,7,2,2,7,5,1
1514,29612,1040921,55,14,1958,4,male,1015.0,39,33,0,1,0,1,0,0,0
1515,3768,2127908,13,23,2000,6,male,110.0,1,1,404,1,0,0,404,1,1
1516,57323,1241906,24,21,1989,4,male,324.0,110,72,1,2,0,2,1,0,0
1517,68265,1911542,25,16,1988,10,male,589.0,165,46,0,1,0,1,0,0,1
1518,72214,1990520,19,1,1994,1,male,408.0,197,178,0,0,0,0,0,0,1
1519,43224,2091614,22,12,1991,5,female,590.0,65,19,90,84,90,69,0,15,1
1520,113,1677748,17,10,1996,11,female,26.0,0,0,0,0,0,0,0,0,1
1521,55806,1211455,22,15,1991,5,female,203.0,101,59,19,14,13,2,6,12,0
1522,19183,1446397,29,10,1984,10,male,304.0,22,13,7,1,0,1,7,0,0
1523,33992,1323503,26,1,1987,1,male,43.0,47,42,9,6,2,6,7,0,0
1524,25485,1696245,77,11,1936,8,female,644.0,32,23,0,2,0,2,0,0,1
1525,61923,1595772,18,19,1995,2,female,471.0,129,63,85,249,85,55,0,194,0
1526,87904,2164309,21,1,1992,2,female,73.0,395,314,377,660,225,326,152,334,0
1527,49091,1118177,15,24,1998,9,female,266.0,79,58,122,207,2,35,120,172,1
1528,68615,1543041,34,6,1979,3,female,195.0,165,115,13,66,13,52,0,14,1
1529,12931,1530389,49,20,1964,2,male,827.0,14,4,2,3,2,3,0,0,1
1530,51789,1034737,48,26,1965,11,female,203.0,88,17,17,52,17,25,0,27,1
1531,25427,1151995,58,16,1955,10,female,96.0,32,29,0,0,0,0,0,0,0
1532,26919,1090478,50,16,1963,12,female,1029.0,35,16,1,2,1,2,0,0,0
1533,77392,1352354,32,23,1981,2,male,1855.0,235,107,5,3,5,3,0,0,1
1534,89949,1889307,18,11,1995,10,female,730.0,453,303,639,146,413,118,226,28,0
1535,545,1088796,25,7,1988,12,male,28.0,0,0,0,0,0,0,0,0,1
1536,73070,1668885,18,30,1995,3,female,295.0,191,90,833,708,44,246,789,462,1
1537,51148,1112269,25,17,1988,7,female,178.0,87,69,164,109,164,74,0,35,1
1538,65214,2188606,22,11,1991,9,male,103.0,146,45,0,0,0,0,0,0,1
1539,41067,1735091,17,10,1996,8,male,912.0,63,19,0,0,0,0,0,0,0
1540,71634,1230732,18,29,1995,11,female,502.0,188,106,28,1,23,0,5,1,0
1541,30264,1729857,38,18,1975,1,male,309.0,41,31,0,0,0,0,0,0,1
1542,44270,1900583,20,4,1993,5,female,141.0,69,14,0,1,0,0,0,1,0
1543,33189,1004437,20,2,1993,6,male,79.0,45,26,44,26,44,18,0,8,1
1544,79804,1578751,59,19,1954,11,male,1586.0,253,40,132,286,0,28,132,258,1
1545,39367,2163237,47,18,1966,2,male,435.0,59,36,0,0,0,0,0,0,1
1546,77860,1312728,55,30,1958,7,male,75.0,233,118,122,249,121,154,1,95,0
1547,76416,1531505,58,25,1955,9,male,1267.0,224,131,5,79,5,72,0,7,1
1548,8529,1486758,30,17,1983,9,male,11.0,7,7,23,10,23,9,0,1,1
1549,67099,2193538,18,7,1995,11,female,8.0,154,119,248,330,113,168,135,162,0
1550,73947,1546642,18,7,1995,10,male,615.0,198,117,298,95,297,86,1,9,1
1551,96900,1013194,19,4,1994,5,male,212.0,998,610,1651,4491,451,2018,1200,2473,0
1552,77866,2120475,67,2,1946,3,female,171.0,232,201,121,122,121,96,0,26,0
1553,90916,1314160,16,9,1997,7,male,328.0,507,312,647,134,124,49,523,85,0
1554,96999,1267229,24,14,1989,9,female,484.0,1171,695,14799,22513,12934,17955,1865,4558,1
1555,50546,1472708,63,8,1950,2,female,874.0,86,27,1,4,1,4,0,0,1
1556,13978,1526474,15,8,1998,1,male,648.0,15,11,4,0,1,0,3,0,0
1557,98864,1280902,17,28,1996,1,female,440.0,2770,700,2041,4932,2041,4230,0,702,0
1558,40535,1667797,69,25,1944,3,female,405.0,61,21,9,23,0,11,9,12,0
1559,37150,1255477,59,15,1954,6,female,101.0,53,45,38,2,0,1,38,1,1
1560,33006,2178059,26,6,1987,6,female,334.0,45,22,13,18,13,16,0,2,0
1561,5059,1550614,25,5,1988,1,male,111.0,3,1,0,0,0,0,0,0,0
1562,41281,1423269,54,18,1959,2,male,1275.0,64,19,0,0,0,0,0,0,0
1563,14197,1305774,33,19,1980,10,male,350.0,15,12,77,62,0,0,77,62,1
1564,48041,1185173,64,5,1949,2,female,1734.0,78,53,59,95,9,52,50,43,1
1565,95733,1113495,17,27,1996,12,male,512.0,899,771,531,192,531,166,0,26,0
1566,34904,1253965,23,14,1990,3,male,281.0,49,19,5,24,5,22,0,2,1
1567,11764,2067488,66,22,1947,4,female,1028.0,12,9,0,0,0,0,0,0,0
1568,61225,1296874,23,27,1990,10,male,310.0,127,114,0,0,0,0,0,0,0
1569,77276,1831950,103,21,1910,10,male,550.0,238,108,1,0,1,0,0,0,1
1570,21989,1194357,27,3,1986,10,male,9.0,27,11,9,3,9,3,0,0,1
1571,23798,1643846,28,13,1985,4,male,26.0,29,28,4,0,4,0,0,0,0
1572,98254,2137946,64,19,1949,10,male,1762.0,2025,834,76,31,36,18,40,13,1
1573,83977,1879039,108,28,1905,9,female,1156.0,304,41,448,214,448,101,0,113,1
1574,36511,1942126,20,17,1993,10,male,150.0,53,53,0,11,0,10,0,1,0
1575,16274,1353167,45,1,1968,9,female,360.0,18,7,229,38,229,27,0,11,1
1576,61365,1118802,33,3,1980,6,male,457.0,129,30,1,12,1,8,0,4,1
1577,26878,1296372,67,1,1946,8,male,1528.0,35,12,1,0,1,0,0,0,0
1578,30154,1645900,22,1,1991,1,male,265.0,40,40,0,0,0,0,0,0,1
1579,37805,2135612,35,17,1978,11,female,150.0,55,32,7,0,5,0,2,0,1
1580,52806,1857861,59,28,1954,11,female,945.0,92,32,32,11,0,2,32,9,1
1581,38397,1235040,22,16,1991,5,male,568.0,57,52,0,0,0,0,0,0,1
1582,14616,1927304,52,20,1961,6,male,198.0,17,13,0,0,0,0,0,0,0
1583,31000,1887278,69,13,1944,6,female,487.0,41,26,46,7,46,2,0,5,0
1584,46130,1233273,37,30,1976,1,female,136.0,71,31,169,175,169,123,0,52,1
1585,758,1641158,26,3,1987,3,male,11.0,0,0,0,0,0,0,0,0,1
1586,31865,1877302,44,2,1969,8,male,1781.0,43,15,8,3,0,2,8,1,1
1587,17374,1714629,31,13,1982,10,male,230.0,20,20,22,37,22,18,0,19,1
1588,34062,1227863,66,26,1947,1,female,1798.0,46,7,15,11,12,3,3,8,1
1589,44425,2022203,55,2,1958,3,female,1621.0,70,42,1,0,1,0,0,0,1
1590,88977,1858652,18,7,1995,1,female,497.0,436,191,583,422,575,254,8,168,0
1591,98869,1763081,20,13,1993,10,male,302.0,2373,437,2399,1652,324,1083,2075,569,0
1592,37048,2000766,21,12,1992,11,female,224.0,53,41,17,2,9,2,8,0,0
1593,12098,1139931,59,28,1954,9,female,198.0,12,9,40,0,0,0,40,0,1
1594,85815,1561371,55,17,1958,4,male,1178.0,355,147,167,28,167,27,0,1,0
1595,20845,2042001,59,7,1954,12,male,1825.0,25,16,4,16,0,10,4,6,0
1596,68047,2040943,16,12,1997,6,female,551.0,160,106,300,61,283,42,17,19,0
1597,80583,1774432,23,1,1990,1,male,1417.0,272,106,28,18,28,14,0,4,0
1598,78340,1272674,25,11,1988,9,male,203.0,242,217,2,3,2,3,0,0,0
1599,45188,1329618,25,8,1988,2,male,282.0,72,3,0,0,0,0,0,0,0
1600,61124,1780840,66,13,1947,3,female,535.0,124,50,1134,146,0,104,1134,42,1
1601,4101,1307356,29,14,1984,6,female,136.0,2,2,0,0,0,0,0,0,0
1602,42826,1931573,21,18,1992,8,male,248.0,66,66,5,0,5,0,0,0,0
1603,82181,1880954,26,9,1987,8,male,302.0,302,190,0,36,0,23,0,13,0
1604,58333,1666742,72,7,1941,6,male,507.0,112,87,1,0,0,0,1,0,1
1605,14516,1781935,34,30,1979,9,female,362.0,16,8,0,15,0,5,0,10,0
1606,90924,1367290,29,10,1984,10,female,1238.0,515,236,612,443,612,351,0,92,1
1607,66979,1219236,16,13,1997,10,female,999.0,155,113,116,241,34,36,82,205,0
1608,73995,1525267,33,13,1980,5,male,578.0,203,115,486,320,486,207,0,113,1
1609,24855,1643401,24,27,1989,8,male,147.0,31,25,7,6,6,6,1,0,0
1610,37226,2086815,47,15,1966,2,female,1280.0,53,31,65,134,64,60,1,74,0
1611,84269,1333705,26,14,1987,3,male,1032.0,330,199,2,6,0,2,2,4,1
1612,67520,1173333,25,7,1988,4,male,249.0,162,149,5,7,5,2,0,5,0
1613,10623,1890277,17,4,1996,2,male,805.0,10,7,17,0,16,0,1,0,1
1614,26427,1950725,64,17,1949,10,female,539.0,32,22,382,6,0,3,382,3,1
1615,27282,1373267,51,29,1962,5,female,14.0,35,34,13,15,13,15,0,0,0
1616,60356,1796509,27,27,1986,2,male,530.0,124,59,0,0,0,0,0,0,0
1617,45713,1584682,24,3,1989,3,male,368.0,72,46,14,0,14,0,0,0,0
1618,95630,1710601,20,11,1993,8,female,570.0,923,293,293,476,293,431,0,45,1
1619,33907,1159405,36,14,1977,2,male,197.0,47,29,5,0,5,0,0,0,0
1620,80315,1004720,17,2,1996,4,male,287.0,266,239,4,0,4,0,0,0,1
1621,19869,1525705,33,1,1980,11,male,572.0,24,1,0,3,0,1,0,2,1
1622,47944,1941579,60,17,1953,7,female,1818.0,77,16,24,3,24,2,0,1,1
1623,7921,1760937,66,19,1947,12,male,503.0,6,5,0,0,0,0,0,0,0
1624,8070,1231470,36,23,1977,10,male,206.0,6,2,1,0,1,0,0,0,1
1625,91747,1981715,47,21,1966,11,female,1593.0,550,206,279,301,218,168,61,133,0
1626,26606,1860353,28,30,1985,10,female,606.0,34,5,0,0,0,0,0,0,0
1627,27084,1648677,23,4,1990,7,male,496.0,35,27,5,0,0,0,5,0,1
1628,38119,1456832,57,10,1956,10,female,267.0,54,9,57,144,0,7,57,137,0
1629,32322,1696889,32,11,1981,3,male,19.0,43,42,208,42,208,31,0,11,1
1630,59056,1491680,25,29,1988,3,male,189.0,114,59,236,72,233,43,3,29,1
1631,69696,1520666,14,14,1999,9,male,348.0,172,107,28,1,0,0,28,1,1
1632,87722,2081983,22,17,1991,6,female,185.0,393,301,125,160,125,118,0,42,1
1633,18094,2037545,20,20,1993,11,male,110.0,21,9,6,12,6,4,0,8,0
1634,13644,1902303,25,1,1988,1,male,65.0,15,12,0,0,0,0,0,0,1
1635,92986,1858429,22,18,1991,12,female,927.0,609,443,1136,852,648,397,488,455,0
1636,1467,1528102,47,22,1966,7,male,74.0,0,0,0,0,0,0,0,0,0
1637,13717,1065226,40,6,1973,3,male,1025.0,15,13,0,5,0,5,0,0,0
1638,78596,1514788,22,8,1991,8,female,698.0,247,126,29,65,29,25,0,40,1
1639,92513,1657669,18,27,1995,1,male,340.0,607,557,88,4,0,0,88,4,0
1640,52507,1619617,21,3,1992,9,female,101.0,93,65,2,35,2,34,0,1,0
1641,46513,1860378,90,5,1923,6,male,2060.0,76,35,0,0,0,0,0,0,1
1642,98317,1934998,15,27,1998,4,female,701.0,2043,137,135,541,135,378,0,163,1
1643,56016,1864037,31,29,1982,1,female,345.0,101,59,71,3,71,3,0,0,1
1644,92091,1960960,25,5,1988,5,female,479.0,599,551,0,0,0,0,0,0,1
1645,73004,1605478,24,21,1989,12,female,499.0,193,116,379,97,365,38,14,59,1
1646,41443,1399406,63,10,1950,3,female,144.0,63,41,1,49,1,49,0,0,0
1647,47704,1109871,26,2,1987,5,female,330.0,78,53,2,3,0,3,2,0,1
1648,75115,1694740,21,12,1992,12,male,622.0,212,103,1668,1001,1424,387,244,614,1
1649,32496,1701875,26,28,1987,4,female,462.0,44,21,0,3,0,3,0,0,0
1650,97367,1661790,17,28,1996,2,female,937.0,1691,477,111,447,72,379,39,68,1
1651,25842,1691875,25,31,1988,12,male,377.0,32,11,6,11,6,9,0,2,0
1652,2519,1898364,29,31,1984,12,female,592.0,1,0,0,0,0,0,0,0,0
1653,61236,2104318,26,1,1987,1,male,447.0,128,109,0,0,0,0,0,0,0
1654,5065,1992250,25,1,1988,1,male,29.0,3,3,0,0,0,0,0,0,1
1655,36677,1338093,23,7,1990,6,female,537.0,53,42,1,0,0,0,1,0,1
1656,79354,1868817,23,23,1990,8,male,1361.0,261,134,6,7,0,7,6,0,0
1657,7278,1229746,42,5,1971,4,male,130.0,5,4,105,38,105,11,0,27,0
1658,60476,1996327,21,30,1992,7,female,664.0,123,72,2,12,1,7,1,5,0
1659,57448,2106932,18,11,1995,8,male,409.0,111,72,3,24,0,13,3,11,0
1660,10078,1038806,26,15,1987,3,male,798.0,10,2,1,1,0,0,1,1,1
1661,59937,1296709,59,1,1954,9,male,1699.0,120,61,61,13,60,6,1,7,0
1662,94965,1997959,23,13,1990,2,female,489.0,740,57,1551,548,1350,525,201,23,1
1663,84982,1075786,63,21,1950,7,female,1795.0,324,145,615,691,582,510,33,181,0
1664,19743,1085580,56,28,1957,5,male,53.0,22,12,549,60,549,47,0,13,1
1665,83020,1939729,15,18,1998,4,male,597.0,303,133,640,19,316,15,324,4,1
1666,7309,1607121,14,14,1999,4,female,394.0,7,7,0,0,0,0,0,0,1
1667,21605,2010326,59,13,1954,2,female,754.0,26,12,1,5,0,2,1,3,0
1668,37549,2081445,45,30,1968,11,female,136.0,54,37,0,0,0,0,0,0,0
1669,97127,1630729,17,17,1996,12,male,928.0,1385,193,8,22,0,21,8,1,0
1670,14443,1210189,28,15,1985,6,male,246.0,17,10,0,0,0,0,0,0,1
1671,24419,1358191,50,27,1963,7,male,284.0,30,21,153,17,0,13,153,4,0
1672,20001,1693321,25,13,1988,6,female,374.0,24,19,1,0,1,0,0,0,1
1673,33557,2115172,28,11,1985,12,male,109.0,47,32,0,0,0,0,0,0,1
1674,87560,2011537,30,6,1983,12,male,637.0,396,335,48,56,48,40,0,16,0
1675,91708,2044941,75,9,1938,10,male,2171.0,569,267,223,163,159,116,64,47,0
1676,82226,2120505,20,18,1993,11,male,1112.0,290,165,1,0,1,0,0,0,0
1677,93638,1442189,108,20,1905,1,female,1742.0,699,539,184,164,158,86,26,78,1
1678,74567,1542626,19,29,1994,11,male,269.0,212,142,22,29,18,26,4,3,0
1679,67112,1969211,18,15,1995,9,female,313.0,155,73,272,112,272,101,0,11,1
1680,50673,1668743,18,6,1995,1,male,95.0,87,58,5,28,5,25,0,3,0
1681,78145,1089468,48,6,1965,4,female,1762.0,234,131,3050,3128,1536,1395,1514,1733,0
1682,3710,1924038,22,4,1991,4,male,138.0,1,0,52,14,52,9,0,5,0
1683,13120,1318095,30,20,1983,4,male,642.0,13,4,7,1,7,0,0,1,1
1684,49586,1417615,25,22,1988,9,female,76.0,82,70,2,6,2,5,0,1,0
1685,56941,2109757,52,28,1961,6,female,1613.0,107,69,81,199,29,159,52,40,0
1686,38807,2085536,25,5,1988,6,female,398.0,56,42,14,0,14,0,0,0,0
1687,96370,1054434,101,1,1912,4,male,1590.0,1199,750,92,160,70,95,22,65,1
1688,17619,1801874,33,5,1980,10,male,610.0,20,6,200,72,200,54,0,18,0
1689,51781,1984530,47,14,1966,7,female,94.0,89,56,16,41,16,26,0,15,1
1690,14966,1760730,108,30,1905,3,female,269.0,16,8,3,0,3,0,0,0,1
1691,41012,1617691,55,7,1958,11,female,269.0,60,38,780,247,780,115,0,132,0
1692,87550,1782228,19,18,1994,10,male,462.0,401,274,45,77,45,64,0,13,0
1693,63009,1330566,22,26,1991,2,female,626.0,134,48,133,211,133,210,0,1,1
1694,7439,1861858,23,23,1990,11,male,197.0,6,3,0,0,0,0,0,0,1
1695,49357,2059194,23,1,1990,1,male,286.0,84,42,0,0,0,0,0,0,0
1696,46054,1188810,54,7,1959,9,male,1758.0,72,42,99,16,78,11,21,5,0
1697,36800,1875358,35,30,1978,9,male,130.0,53,37,2,4,2,3,0,1,0
1698,58917,1579637,30,19,1983,2,male,396.0,113,86,85,221,85,151,0,70,1
1699,30693,1047530,23,8,1990,8,female,699.0,40,34,7,18,7,17,0,1,0
1700,69490,1710881,25,17,1988,7,male,530.0,171,82,5,16,5,16,0,0,0
1701,20666,1009475,54,24,1959,2,female,1824.0,25,13,0,7,0,6,0,1,0
1702,35998,1511121,63,19,1950,5,female,717.0,50,41,13,2,2,2,11,0,1
1703,69949,1105905,56,7,1957,10,female,256.0,171,134,175,76,12,20,163,56,1
1704,18676,1509811,53,6,1960,11,male,102.0,22,17,0,0,0,0,0,0,0
1705,8565,2011913,30,1,1983,6,male,8.0,6,6,32,2,32,1,0,1,0
1706,1497,1155731,50,10,1963,2,male,498.0,0,0,0,0,0,0,0,0,1
1707,38329,1947050,64,5,1949,6,male,1566.0,55,25,3332,327,3332,238,0,89,0
1708,8776,1499307,23,28,1990,1,male,443.0,8,5,0,1,0,0,0,1,0
1709,6802,1884135,44,30,1969,1,female,134.0,5,4,0,11,0,2,0,9,1
1710,24881,1333658,30,29,1983,11,male,459.0,31,20,9,0,9,0,0,0,1
1711,84195,1276729,26,5,1987,2,male,521.0,322,184,0,0,0,0,0,0,1
1712,74944,2165441,47,6,1966,3,female,140.0,210,114,240,80,240,62,0,18,1
1713,30388,2139299,23,5,1990,9,male,426.0,40,20,1,0,1,0,0,0,0
1714,7219,1951355,21,23,1992,1,female,316.0,5,1,20,23,20,22,0,1,0
1715,31681,1845536,45,24,1968,4,male,559.0,42,28,2,10,2,9,0,1,0
1716,74949,2042103,16,21,1997,8,female,419.0,211,59,255,125,255,125,0,0,1
1717,70561,1811568,20,21,1993,4,female,563.0,176,109,13,7,0,2,13,5,0
1718,20552,1618771,23,19,1990,6,male,216.0,25,4,0,0,0,0,0,0,0
1719,33590,2181533,33,5,1980,5,male,410.0,47,28,0,0,0,0,0,0,0
1720,28640,1407810,17,19,1996,9,male,133.0,37,30,1,0,1,0,0,0,1
1721,69106,1540590,24,6,1989,6,female,478.0,163,91,395,90,300,53,95,37,0
1722,38038,1469914,60,29,1953,8,female,1230.0,54,30,32,11,32,4,0,7,1
1723,23866,1915046,16,26,1997,8,male,123.0,29,20,6,5,5,4,1,1,0
1724,47036,1614136,42,7,1971,7,female,411.0,75,45,27,22,27,20,0,2,0
1725,90458,1637797,103,28,1910,3,female,1257.0,507,140,40,5,7,3,33,2,1
1726,60639,1928701,20,3,1993,10,female,283.0,124,97,10,3,8,2,2,1,0
1727,78317,1004601,15,26,1998,7,female,241.0,242,148,2,11,0,1,2,10,0
1728,60365,1778221,28,26,1985,7,male,300.0,123,57,0,1,0,0,0,1,1
1729,86078,2103669,44,10,1969,12,male,468.0,354,219,1302,1203,709,724,593,479,0
1730,43214,1831509,34,15,1979,6,male,201.0,66,54,83,57,83,3,0,54,0
1731,77390,1150988,28,28,1985,8,male,332.0,240,209,5,0,5,0,0,0,0
1732,36142,1959431,60,10,1953,1,female,863.0,51,31,35,28,0,15,35,13,0
1733,11091,1827838,65,14,1948,1,female,301.0,11,4,0,0,0,0,0,0,1
1734,98608,1590957,23,8,1990,8,female,1231.0,2604,543,679,3020,529,2635,150,385,0
1735,87559,1673550,20,2,1993,10,male,462.0,395,293,48,16,48,16,0,0,0
1736,47443,1848474,18,22,1995,8,female,269.0,74,44,763,305,3,96,760,209,1
1737,44153,1911164,74,9,1939,11,female,1118.0,67,50,203,27,203,16,0,11,1
1738,48528,1553965,30,7,1983,2,male,620.0,81,51,2,24,2,20,0,4,0
1739,12456,1016243,33,4,1980,1,male,205.0,14,8,0,2,0,1,0,1,1
1740,60411,1902708,108,24,1905,5,female,1462.0,122,42,0,3,0,0,0,3,0
1741,2525,1936018,28,15,1985,1,male,26.0,1,1,0,0,0,0,0,0,0
1742,43537,2109381,54,14,1959,8,male,381.0,67,55,0,0,0,0,0,0,1
1743,5189,1804703,33,20,1980,8,male,255.0,3,2,0,0,0,0,0,0,1
1744,56134,1765804,40,14,1973,8,female,747.0,101,54,154,25,148,23,6,2,1
1745,4204,1166539,35,7,1978,2,female,206.0,2,0,0,0,0,0,0,0,0
1746,35445,1596232,23,24,1990,10,female,572.0,49,24,1121,274,1121,199,0,75,0
1747,78557,1251186,63,3,1950,3,female,1071.0,245,221,20,16,10,6,10,10,1
1748,12782,1704094,17,1,1996,10,male,301.0,14,8,1,1,1,1,0,0,0
1749,80174,1663710,28,17,1985,1,female,1252.0,267,14,0,4,0,1,0,3,1
1750,93374,1364769,18,12,1995,12,male,341.0,649,372,37,45,2,9,35,36,0
1751,14303,1862143,19,4,1994,4,male,47.0,16,11,0,13,0,10,0,3,0
1752,15689,1396578,28,1,1985,8,female,211.0,18,7,0,0,0,0,0,0,0
1753,203,1809067,19,21,1994,12,male,18.0,0,0,0,0,0,0,0,0,0
1754,89305,1520230,21,24,1992,11,male,887.0,469,265,5,38,5,24,0,14,0
1755,85295,1283454,108,5,1905,7,female,877.0,344,166,3,58,3,49,0,9,1
1756,92584,1320030,19,16,1994,5,male,683.0,621,474,129,87,129,74,0,13,0
1757,14923,2178259,31,21,1982,6,male,215.0,17,10,2,30,2,23,0,7,1
1758,98540,1362239,68,29,1945,1,female,743.0,4724,1149,496,1630,424,1321,72,309,1
1759,12772,1046796,53,31,1960,12,female,315.0,14,14,1,0,1,0,0,0,0
1760,57952,1094646,25,12,1988,2,female,905.0,110,52,89,69,89,41,0,28,0
1761,5544,1685461,45,9,1968,12,male,118.0,3,2,3,0,3,0,0,0,1
1762,1757,1767978,54,16,1959,8,male,53.0,0,0,1,0,1,0,0,0,1
1763,70069,1453255,22,16,1991,12,male,745.0,174,76,457,120,59,22,398,98,1
1764,56117,1416043,46,9,1967,9,male,496.0,103,71,146,22,7,18,139,4,0
1765,73205,1957119,25,15,1988,1,female,199.0,199,101,0,3,0,2,0,1,0
1766,58761,1555343,19,18,1994,10,female,713.0,114,80,29,26,29,25,0,1,1
1767,47330,2150392,28,27,1985,2,female,356.0,76,56,198,38,0,17,198,21,1
1768,68666,1443781,16,18,1997,12,female,173.0,163,65,19,37,19,14,0,23,1
1769,42702,1916217,60,20,1953,8,male,1746.0,65,3,1,3,1,2,0,1,0
1770,41680,1321839,43,20,1970,10,male,367.0,64,48,6,62,6,52,0,10,1
1771,28221,2041084,47,5,1966,6,female,933.0,36,18,96,37,95,14,1,23,1
1772,96770,1753908,16,9,1997,8,female,497.0,1087,850,872,564,372,343,500,221,1
1773,76087,2113316,66,19,1947,3,female,1322.0,219,49,588,144,20,75,568,69,1
1774,92819,2022839,30,23,1983,2,female,732.0,591,257,440,459,316,264,124,195,1
1775,25589,1102699,20,9,1993,11,male,53.0,32,18,1,3,1,2,0,1,0
1776,75680,1057988,33,13,1980,2,female,618.0,221,61,40,24,0,4,40,20,0
1777,49448,1530204,65,23,1948,12,female,837.0,84,55,0,13,0,5,0,8,1
1778,70154,1967013,43,24,1970,6,female,760.0,174,78,2566,3252,1787,2739,779,513,1
1779,93867,1466312,113,30,1900,9,female,1562.0,705,366,664,189,132,170,532,19,0
1780,5358,1248247,62,6,1951,8,female,88.0,3,3,0,0,0,0,0,0,0
1781,86697,1925396,25,22,1988,8,female,519.0,369,221,104,78,41,25,63,53,1
1782,62414,1763018,61,4,1952,7,male,308.0,132,84,1,9,1,8,0,1,1
1783,93677,2075076,23,2,1990,6,male,549.0,656,473,227,132,227,116,0,16,1
1784,7927,1631235,65,28,1948,7,male,541.0,7,7,0,3,0,1,0,2,0
1785,19196,1099061,72,21,1941,8,male,1815.0,22,12,7,8,2,7,5,1,1
1786,39352,1146737,38,2,1975,9,male,156.0,58,31,0,0,0,0,0,0,0
1787,57781,1126145,24,4,1989,5,male,590.0,109,66,34,5,34,5,0,0,1
1788,96534,1996158,27,2,1986,2,male,429.0,1229,946,254,572,0,104,254,468,1
1789,14572,1108745,43,23,1970,7,male,446.0,16,10,0,0,0,0,0,0,0
1790,9169,1893822,60,26,1953,2,male,1476.0,8,4,4,6,0,5,4,1,0
1791,4617,1304860,27,28,1986,8,female,351.0,2,2,2,0,2,0,0,0,0
1792,71179,1828986,20,7,1993,7,male,538.0,187,93,0,13,0,13,0,0,0
1793,56242,1035898,35,15,1978,11,female,173.0,103,55,352,67,0,7,352,60,0
1794,31941,1211954,48,21,1965,10,male,521.0,42,10,11,45,11,22,0,23,0
1795,78526,1756822,25,12,1988,2,male,573.0,241,190,16,18,16,18,0,0,1
1796,4563,1323507,44,11,1969,9,male,7.0,2,2,1,0,1,0,0,0,1
1797,76428,1742271,21,2,1992,12,female,491.0,230,110,6,43,6,38,0,5,0
1798,5435,1578941,24,1,1989,1,male,55.0,3,3,1,0,1,0,0,0,1
1799,24889,1289579,25,18,1988,6,female,453.0,31,26,10,1,7,1,3,0,1
1800,89141,1272429,19,25,1994,5,female,445.0,468,81,0,0,0,0,0,0,1
1801,63437,1755671,23,1,1990,11,male,454.0,135,56,1,3,1,2,0,1,1
1802,42915,1810371,29,1,1984,2,female,318.0,65,41,10,10,8,5,2,5,0
1803,8277,1607905,19,12,1994,11,female,431.0,7,5,4,0,3,0,1,0,0
1804,15967,1633332,52,1,1961,12,male,293.0,18,8,3,0,3,0,0,0,0
1805,45553,1615516,94,7,1919,3,female,1299.0,72,25,6,8,0,1,6,7,0
1806,523,1204593,23,5,1990,9,male,389.0,0,0,0,0,0,0,0,0,0
1807,51114,1336026,50,29,1963,3,female,1293.0,86,44,121,24,87,9,34,15,0
1808,70064,2090858,36,15,1977,7,female,366.0,172,140,427,184,416,110,11,74,0
1809,67487,1569850,21,10,1992,1,male,453.0,158,85,3,7,3,5,0,2,1
1810,49964,1442611,113,14,1900,1,female,1820.0,84,40,40,2,40,2,0,0,1
1811,10529,1296604,44,13,1969,1,male,443.0,10,5,9,6,9,4,0,2,1
1812,63563,2180300,29,21,1984,4,female,665.0,137,97,6,7,6,6,0,1,0
1813,62887,1215309,54,13,1959,5,female,2245.0,134,78,61,33,61,7,0,26,0
1814,2264,2114393,22,23,1991,9,male,418.0,1,1,0,0,0,0,0,0,0
1815,98117,1216554,17,1,1996,3,male,540.0,4135,2450,14,62,0,51,14,11,0
1816,34091,1734165,19,12,1994,9,female,345.0,46,19,18,0,18,0,0,0,1
1817,73702,2069539,23,12,1990,11,male,476.0,201,127,55,85,47,34,8,51,0
1818,89485,1720400,26,1,1987,1,male,781.0,451,293,36,149,26,130,10,19,1
1819,26789,2150337,100,7,1913,2,male,923.0,34,11,0,0,0,0,0,0,1
1820,7437,1357043,23,6,1990,11,male,618.0,6,1,0,0,0,0,0,0,1
1821,96793,1219119,26,17,1987,8,male,395.0,1153,758,890,348,890,317,0,31,1
1822,6611,1775407,25,13,1988,11,male,521.0,5,2,0,0,0,0,0,0,0
1823,88438,2182816,16,22,1997,1,male,439.0,431,265,21,57,2,10,19,47,1
1824,15264,2090538,71,2,1942,9,female,922.0,17,11,17,2,0,1,17,1,0
1825,35684,1695851,50,3,1963,10,female,369.0,50,42,1,1,0,1,1,0,1
1826,72131,1485936,23,16,1990,1,female,138.0,185,153,915,866,766,518,149,348,1
1827,16363,1135035,20,15,1993,10,female,535.0,20,10,0,0,0,0,0,0,1
1828,69721,1537560,19,30,1994,4,male,1067.0,174,45,32,1,32,1,0,0,0
1829,54571,1777185,22,31,1991,8,male,266.0,98,67,2,100,2,54,0,46,1
1830,47117,1083898,65,21,1948,6,male,709.0,75,49,43,6,4,1,39,5,0
1831,53142,1179423,47,4,1966,10,female,865.0,91,50,2270,340,417,211,1853,129,1
1832,60280,1037587,16,22,1997,3,female,420.0,123,91,0,0,0,0,0,0,1
1833,79233,2113596,26,19,1987,8,male,612.0,254,148,1,1,1,1,0,0,0
1834,75328,1487763,13,27,2000,4,male,183.0,219,200,3,27,1,6,2,21,0
1835,9714,1677981,29,7,1984,9,female,582.0,10,6,0,0,0,0,0,0,1
1836,49121,1939500,18,2,1995,5,female,263.0,81,46,158,72,1,7,157,65,1
1837,52683,1935924,22,6,1991,4,male,639.0,93,42,10,42,10,38,0,4,0
1838,8103,1619452,42,2,1971,7,male,306.0,6,4,1,1,1,0,0,1,0
1839,82278,1792228,21,26,1992,5,female,281.0,289,140,2,25,2,21,0,4,1
1840,45196,1170888,26,1,1987,4,male,246.0,72,62,0,5,0,0,0,5,1
1841,9306,1674545,54,16,1959,9,female,311.0,8,7,24,0,24,0,0,0,1
1842,2890,1340096,42,14,1971,7,male,315.0,1,1,0,0,0,0,0,0,1
1843,44537,1809603,14,19,1999,3,male,182.0,69,36,4,0,4,0,0,0,1
1844,77048,1513933,13,16,2000,4,male,189.0,228,166,545,58,542,21,3,37,1
1845,88916,1042995,60,11,1953,12,female,703.0,424,262,380,27,344,7,36,20,1
1846,39085,1966302,39,10,1974,3,female,272.0,57,40,115,4,115,4,0,0,1
1847,10882,1715831,20,6,1993,6,female,42.0,11,11,0,0,0,0,0,0,1
1848,29993,1435546,33,11,1980,9,male,254.0,39,28,84,29,0,12,84,17,0
1849,71777,1813091,17,28,1996,3,male,117.0,186,167,64,14,64,9,0,5,0
1850,89031,1675994,30,17,1983,10,female,864.0,428,235,1021,594,660,292,361,302,1
1851,31096,2103256,82,7,1931,5,female,1115.0,40,20,91,87,90,84,1,3,0
1852,28077,1775099,60,12,1953,11,female,265.0,36,15,16,4,16,4,0,0,1
1853,21136,1100291,26,8,1987,2,female,109.0,25,15,254,50,163,24,91,26,1
1854,40379,1795539,25,21,1988,10,female,90.0,60,33,2,10,2,9,0,1,0
1855,54108,2156352,25,3,1988,3,female,385.0,94,51,109,64,31,25,78,39,1
1856,13180,1431293,18,3,1995,7,female,851.0,13,12,10,0,10,0,0,0,0
1857,61316,1727209,57,30,1956,12,male,457.0,126,112,1,0,0,0,1,0,0
1858,78863,1045528,39,20,1974,4,female,548.0,243,182,178,118,178,105,0,13,0
1859,76199,1293459,19,23,1994,3,female,728.0,223,138,0,2,0,1,0,1,0
1860,71302,1565340,22,23,1991,1,female,425.0,184,46,1,6,1,1,0,5,1
1861,95942,1259677,16,19,1997,10,male,207.0,945,619,2195,2249,1143,1003,1052,1246,1
1862,37677,1068916,19,14,1994,9,male,253.0,54,28,2,2,2,1,0,1,0
1863,52145,1931654,108,18,1905,12,male,2.0,89,79,231,47,0,3,231,44,1
1864,77608,1455775,29,5,1984,2,male,473.0,232,167,30,12,0,1,30,11,1
1865,41503,2071756,27,23,1986,6,male,170.0,64,62,2,12,2,8,0,4,0
1866,77527,1534346,13,4,2000,1,male,39.0,233,215,18,15,2,6,16,9,0
1867,31377,1149722,27,5,1986,2,female,608.0,42,33,0,0,0,0,0,0,1
1868,2968,2078533,47,6,1966,6,male,564.0,1,1,0,1,0,0,0,1,1
1869,64052,1834868,21,18,1992,2,male,204.0,138,56,197,59,197,38,0,21,1
1870,3211,1532781,20,31,1993,7,female,95.0,1,1,1,0,1,0,0,0,1
1871,11255,1242359,17,14,1996,8,male,173.0,11,11,4,1,0,1,4,0,1
1872,75042,1888326,24,20,1989,7,male,514.0,208,99,549,267,549,99,0,168,0
1873,23143,1264056,16,9,1997,9,male,35.0,30,26,0,2,0,0,0,2,1
1874,84439,1115757,50,4,1963,4,female,613.0,326,211,14,124,0,20,14,104,0
1875,77206,1756214,24,21,1989,1,male,448.0,231,176,0,2,0,2,0,0,1
1876,46718,1119099,18,21,1995,11,male,255.0,75,55,3,5,3,3,0,2,1
1877,94966,1453561,27,7,1986,8,male,527.0,804,719,1685,544,1456,427,229,117,0
1878,27472,1653053,46,16,1967,10,female,270.0,34,18,49,35,0,1,49,34,0
1879,41531,1621585,70,26,1943,5,female,1130.0,63,33,3,0,2,0,1,0,0
1880,65742,1977922,45,21,1968,6,male,1598.0,148,105,29,8,27,8,2,0,1
1881,24509,1227559,17,13,1996,3,male,454.0,31,17,0,1,0,1,0,0,0
1882,75793,1559659,20,31,1993,7,male,1544.0,221,54,71,54,71,33,0,21,0
1883,67910,1436613,35,11,1978,2,female,455.0,159,54,103,54,103,45,0,9,0
1884,8868,1206800,30,21,1983,9,male,498.0,8,5,0,0,0,0,0,0,0
1885,2105,1738109,18,16,1995,7,male,403.0,1,1,0,0,0,0,0,0,0
1886,24429,1174626,53,6,1960,5,male,360.0,30,14,167,28,167,16,0,12,0
1887,47396,2020414,71,22,1942,11,female,356.0,76,49,346,46,325,29,21,17,0
1888,18032,1947382,20,27,1993,8,female,267.0,21,13,3,7,3,5,0,2,0
1889,66500,1627088,16,17,1997,1,male,746.0,156,71,4,4,2,3,2,1,0
1890,53592,1627372,20,12,1993,2,male,144.0,96,87,6,62,6,56,0,6,1
1891,70336,1291107,22,6,1991,1,female,151.0,182,152,1,8,1,7,0,1,0
1892,50503,2146311,16,12,1997,1,male,230.0,87,23,1,0,1,0,0,0,0
1893,22949,1488271,53,31,1960,1,female,612.0,28,10,23,6,23,3,0,3,0
1894,67714,1853512,24,15,1989,1,male,472.0,157,119,28,1,28,1,0,0,1
1895,89310,1329665,39,21,1974,7,male,205.0,475,382,6,0,0,0,6,0,1
1896,48225,1787210,41,28,1972,5,female,211.0,78,44,1250,1457,1250,783,0,674,1
1897,43422,2099770,19,19,1994,8,male,539.0,68,43,0,10,0,1,0,9,0
1898,29043,1113454,25,1,1988,1,male,127.0,38,33,13,29,5,11,8,18,1
1899,52319,1891399,24,25,1989,10,female,472.0,91,47,0,0,0,0,0,0,0
1900,76856,2164067,63,5,1950,9,male,750.0,224,95,121,76,1,30,120,46,1
1901,33497,1628066,23,27,1990,11,male,25.0,46,41,0,10,0,5,0,5,1
1902,33672,1525399,102,12,1911,1,female,131.0,47,40,0,0,0,0,0,0,0
1903,56114,1379131,51,11,1962,8,female,1465.0,102,24,139,110,131,57,8,53,1
1904,2867,1002347,41,9,1972,3,female,153.0,1,0,0,0,0,0,0,0,1
1905,71954,2124302,23,24,1990,4,male,747.0,187,94,187,168,143,87,44,81,0
1906,61776,1761338,102,18,1911,9,female,2051.0,129,18,40,9,0,3,40,6,0
1907,62599,1242526,15,25,1998,9,male,353.0,133,71,9,14,0,1,9,13,1
1908,89600,1994538,18,8,1995,11,female,512.0,441,212,71,167,55,108,16,59,0
1909,43165,1159461,18,30,1995,3,female,242.0,65,35,60,30,60,17,0,13,1
1910,4403,2102598,56,25,1957,12,male,13.0,2,2,0,0,0,0,0,0,0
1911,56957,1896976,18,4,1995,4,male,83.0,106,98,98,7,0,0,98,7,0
1912,40982,1446726,29,6,1984,1,female,259.0,61,45,371,329,51,60,320,269,1
1913,67162,1557601,56,2,1957,9,female,174.0,156,140,451,77,1,47,450,30,0
1914,49262,1269453,58,6,1955,5,female,880.0,79,59,776,185,745,118,31,67,1
1915,51390,1519911,32,2,1981,10,male,174.0,90,75,0,1,0,0,0,1,1
1916,91478,1977491,16,23,1997,6,female,137.0,551,467,56,137,55,99,1,38,1
1917,85936,1753537,86,10,1927,6,female,553.0,342,246,382,273,0,142,382,131,1
1918,65505,2159176,43,30,1970,9,male,239.0,148,32,5,2,5,2,0,0,1
1919,80757,1367691,21,25,1992,8,female,711.0,265,148,81,84,72,81,9,3,0
1920,28469,1859036,31,21,1982,7,male,730.0,37,2,0,3,0,1,0,2,0
1921,45319,1519333,60,14,1953,10,female,1829.0,72,31,1,9,0,3,1,6,1
1922,74355,1305518,76,19,1937,6,female,816.0,205,129,4,17,2,7,2,10,1
1923,66140,1950687,45,21,1968,3,female,1417.0,145,108,360,235,252,160,108,75,0
1924,65891,1907401,25,16,1988,1,female,158.0,148,90,74,48,29,29,45,19,1
1925,55877,1975519,32,25,1981,7,male,199.0,102,83,28,90,27,52,1,38,1
1926,32695,1258388,41,26,1972,10,male,523.0,44,13,1,1,1,1,0,0,0
1927,15419,2025605,26,18,1987,8,female,278.0,17,8,59,7,30,4,29,3,1
1928,40922,1654367,45,18,1968,7,female,424.0,61,45,188,139,103,34,85,105,0
1929,58199,2002363,17,12,1996,12,male,222.0,112,88,0,10,0,4,0,6,0
1930,1713,1194160,37,8,1976,4,male,530.0,0,0,1,0,0,0,1,0,0
1931,75960,2112357,49,11,1964,9,female,2266.0,221,106,189,190,189,170,0,20,1
1932,96141,1431056,19,15,1994,3,male,679.0,1131,357,6,9,6,8,0,1,0
1933,83275,1830030,14,22,1999,5,female,189.0,309,66,2,6,2,4,0,2,1
1934,94411,1124158,20,19,1993,5,male,704.0,741,464,56,771,56,668,0,103,1
1935,77242,1516676,56,29,1957,5,male,390.0,238,54,0,0,0,0,0,0,0
1936,6684,1813812,29,22,1984,6,male,249.0,5,5,0,0,0,0,0,0,1
1937,30786,1443605,14,12,1999,3,female,258.0,40,28,13,0,13,0,0,0,1
1938,58748,1591414,62,8,1951,2,female,1213.0,114,58,27,20,27,9,0,11,1
1939,94300,2059300,18,17,1995,10,male,512.0,802,465,23,39,0,20,23,19,1
1940,66509,2048449,19,6,1994,7,male,353.0,152,118,4,1,4,0,0,1,1
1941,96748,1242403,19,9,1994,7,female,1545.0,1186,316,775,1530,396,445,379,1085,0
1942,73171,1392439,19,23,1994,8,female,657.0,198,63,0,0,0,0,0,0,1
1943,23265,1210479,26,4,1987,8,male,652.0,30,16,0,0,0,0,0,0,0
1944,19319,1967344,30,28,1983,8,female,560.0,22,11,12,1,12,1,0,0,1
1945,14801,2134597,41,22,1972,8,female,442.0,17,16,1,1,1,1,0,0,0
1946,18697,1527917,57,11,1956,6,male,602.0,23,9,0,2,0,2,0,0,1
1947,91617,1741527,24,29,1989,6,female,778.0,566,385,143,306,63,141,80,165,1
1948,21646,1998634,62,17,1951,12,male,164.0,27,24,1,0,1,0,0,0,1
1949,3565,2087994,36,12,1977,8,male,14.0,1,0,9,5,9,5,0,0,0
1950,25984,2047939,29,13,1984,8,female,523.0,32,25,13,0,13,0,0,0,0
1951,30908,1746414,28,1,1985,1,male,116.0,40,31,27,15,27,15,0,0,0
1952,97219,1929749,68,4,1945,5,male,1060.0,1404,650,27,100,27,72,0,28,0
1953,41372,2107569,20,1,1993,8,male,211.0,64,61,1,0,1,0,0,0,0
1954,38056,1726176,47,21,1966,12,female,1113.0,55,43,37,66,0,12,37,54,1
1955,4345,2159349,46,15,1967,7,male,199.0,2,1,0,0,0,0,0,0,0
1956,14802,2173184,41,15,1972,8,male,143.0,17,10,1,1,1,1,0,0,1
1957,61615,1705062,24,25,1989,10,male,199.0,125,77,12,9,12,9,0,0,0
1958,24074,1948844,21,25,1992,6,female,195.0,29,14,17,6,17,2,0,4,0
1959,20679,1931285,57,24,1956,5,female,1167.0,25,12,0,0,0,0,0,0,0
1960,59234,1558297,20,19,1993,11,male,502.0,116,98,0,0,0,0,0,0,1
1961,15255,1167450,54,10,1959,11,female,435.0,17,6,16,11,9,5,7,6,0
1962,76322,1980814,60,5,1953,6,male,2133.0,223,170,2,1,0,1,2,0,0
1963,90872,1991560,28,20,1985,8,male,1760.0,496,121,436,513,333,108,103,405,0
1964,44698,1028984,60,13,1953,5,female,117.0,70,42,14,10,0,3,14,7,0
1965,83556,1817937,69,29,1944,5,male,316.0,312,19,35,75,0,33,35,42,1
1966,20165,1452190,18,1,1995,1,male,210.0,24,18,5,0,5,0,0,0,0
1967,10186,1793946,32,1,1981,9,male,1068.0,10,1,1,1,1,1,0,0,1
1968,65216,1148371,23,27,1990,1,male,361.0,147,44,0,0,0,0,0,0,1
1969,25451,1853315,64,10,1949,6,female,2147.0,32,15,0,0,0,0,0,0,1
1970,70245,1061635,31,13,1982,6,male,759.0,177,111,0,5,0,1,0,4,0
1971,40488,2128975,37,12,1976,9,male,671.0,61,37,6,0,6,0,0,0,1
1972,43012,2188714,41,16,1972,10,female,343.0,66,49,20,11,20,1,0,10,0
1973,56614,2079785,25,5,1988,6,female,406.0,106,43,4,6,4,6,0,0,1
1974,32703,1023015,23,8,1990,1,female,268.0,44,29,1,4,1,4,0,0,1
1975,91672,2085716,20,8,1993,7,female,627.0,542,154,183,285,183,274,0,11,1
1976,82034,1629014,18,8,1995,11,female,440.0,283,120,780,571,355,250,425,321,0
1977,61967,1840122,53,23,1960,1,male,154.0,125,78,117,6,117,3,0,3,1
1978,45659,1699997,35,24,1978,12,male,654.0,71,67,10,17,10,17,0,0,0
1979,38649,1621965,22,11,1991,5,female,91.0,56,12,3,6,3,3,0,3,1
1980,36694,1299813,54,20,1959,1,male,575.0,53,39,1,15,0,7,1,8,0
1981,37290,1724395,24,12,1989,5,female,358.0,52,29,115,52,115,36,0,16,1
1982,79935,1717499,29,12,1984,9,female,938.0,258,119,329,290,289,223,40,67,0
1983,62698,1465633,19,16,1994,3,male,273.0,132,114,18,22,3,4,15,18,0
1984,56424,1579938,32,24,1981,5,male,139.0,107,80,0,0,0,0,0,0,0
1985,20864,1741766,85,3,1928,7,female,565.0,25,19,5,1,3,1,2,0,0
1986,22442,1460517,35,21,1978,4,male,1902.0,26,23,512,298,510,265,2,33,1
1987,7352,1521459,17,1,1996,3,male,128.0,6,3,0,0,0,0,0,0,0
1988,53532,2023137,52,17,1961,4,male,529.0,97,55,4,1,4,1,0,0,1
1989,38883,1393877,21,14,1992,11,male,434.0,56,1,24,27,24,24,0,3,1
1990,9743,1867026,31,17,1982,3,male,32.0,9,8,0,0,0,0,0,0,1
1991,35504,1385426,19,23,1994,7,male,73.0,51,40,0,0,0,0,0,0,0
1992,61604,1489121,28,3,1985,10,male,607.0,128,82,12,11,0,5,12,6,1
1993,12678,1720805,39,3,1974,11,male,193.0,14,8,1,0,0,0,1,0,0
1994,89416,1699112,108,5,1905,8,female,1194.0,449,224,22,14,0,7,22,7,0
1995,35900,2164793,89,19,1924,1,male,1814.0,51,4,7,6,1,6,6,0,0
1996,76114,1172067,51,27,1962,11,male,1608.0,216,112,819,472,501,318,318,154,1
1997,30030,1801266,13,1,2000,5,female,175.0,39,25,149,39,149,28,0,11,0
1998,96007,1710783,20,2,1993,11,male,1389.0,936,578,3718,957,2729,684,989,273,0
1999,66703,1737869,70,21,1943,4,female,897.0,151,53,19,122,15,50,4,72,0
