,index,userid,age,dob_day,dob_year,dob_month,gender,tenure,friend_count,friendships_initiated,likes,likes_received,mobile_likes,mobile_likes_received,www_likes,www_likes_received
0,58594,1240616,48,11,1965,2,female,806.0,114,72,10,5,8,4,2,1
1,37176,1137097,33,10,1980,9,female,413.0,52,34,44,43,44,43,0,0
2,29997,1098001,28,11,1985,9,male,67.0,39,35,86,53,82,41,4,12
3,70752,1146317,91,22,1922,2,male,817.0,181,158,47,67,47,56,0,11
4,9934,1790978,51,17,1962,7,male,257.0,10,7,0,0,0,0,0,0
5,42036,2168376,18,3,1995,11,male,693.0,62,37,40,10,6,2,34,8
6,72655,1568501,21,22,1992,8,female,506.0,191,87,29,49,11,37,18,12
7,62729,1045011,53,3,1960,2,female,925.0,131,84,22,8,22,6,0,2
8,37717,1379418,28,2,1985,2,male,396.0,54,52,3,0,3,0,0,0
9,49166,1612719,26,6,1987,11,female,50.0,81,56,226,690,102,178,124,512
10,33938,1337509,23,8,1990,6,male,505.0,47,22,6,2,6,2,0,0
11,86921,1587836,19,24,1994,5,male,136.0,372,352,403,359,245,141,158,218
12,24522,1720597,19,15,1994,1,male,1134.0,31,8,0,0,0,0,0,0
13,83068,1019795,23,5,1990,3,female,312.0,292,188,935,353,919,279,16,74
14,36522,1250740,22,29,1991,7,male,162.0,53,40,0,6,0,1,0,5
15,84474,2123890,15,1,1998,8,female,316.0,324,136,19,19,19,16,0,3
16,97849,1420221,19,18,1994,10,female,608.0,1441,604,1606,1104,1548,952,58,152
17,4484,2123069,28,2,1985,5,male,625.0,2,1,1,0,0,0,1,0
18,12502,1423838,38,30,1975,7,male,228.0,13,9,0,0,0,0,0,0
19,96390,1704701,18,30,1995,1,male,642.0,1126,444,113,143,0,33,113,110
20,32055,1861393,18,15,1995,8,male,112.0,43,39,26,11,3,1,23,10
21,27241,1928149,27,8,1986,6,male,289.0,35,19,11,4,0,1,11,3
22,4387,1722470,53,19,1960,2,female,75.0,2,2,0,0,0,0,0,0
23,47728,1972903,23,10,1990,1,female,234.0,78,46,3,0,0,0,3,0
24,23052,1801445,39,1,1974,4,male,202.0,28,23,76,38,76,28,0,10
25,65745,2026822,108,14,1905,7,male,479.0,147,108,29,17,29,14,0,3
26,64131,1691727,95,30,1918,12,male,381.0,135,97,398,624,2,332,396,292
27,68095,1131008,38,3,1975,8,female,969.0,162,62,429,222,74,144,355,78
28,76674,1159292,16,8,1997,7,male,1051.0,225,135,40,10,4,1,36,9
29,37369,1013012,54,2,1959,1,male,1090.0,52,37,296,99,3,4,293,95
30,812,1162568,27,24,1986,3,male,3.0,0,0,0,0,0,0,0,0
31,85453,2038983,83,2,1930,8,male,1525.0,340,188,18,23,18,22,0,1
32,48998,2037391,48,29,1965,9,female,439.0,80,40,64,10,64,8,0,2
33,59365,1980424,109,16,1904,3,male,1610.0,120,34,0,157,0,88,0,69
34,64895,1719264,22,6,1991,2,male,182.0,142,87,97,39,78,35,19,4
35,30623,1803495,21,25,1992,6,male,833.0,41,19,5,1,0,0,5,1
36,94143,1195569,29,10,1984,5,male,892.0,779,686,2,8,2,8,0,0
37,78654,1069686,14,6,1999,4,female,543.0,245,76,43,90,18,19,25,71
38,67779,2057864,108,14,1905,10,female,2339.0,158,53,46,4,1,3,45,1
39,14303,1862143,19,4,1994,4,male,47.0,16,11,0,13,0,10,0,3
40,71386,2088342,24,29,1989,4,male,594.0,183,125,3,7,3,4,0,3
41,77177,1435018,20,10,1993,9,female,670.0,231,158,0,1,0,0,0,1
42,95851,1375876,20,29,1993,1,female,1096.0,886,510,1055,903,417,497,638,406
43,52342,1784780,29,27,1984,12,male,287.0,92,54,0,1,0,1,0,0
44,5402,1844940,30,1,1983,1,male,1349.0,3,1,1,0,0,0,1,0
45,2411,1695153,25,1,1988,1,male,18.0,1,1,0,0,0,0,0,0
46,3653,1621195,45,1,1968,5,male,648.0,1,1,24,5,22,1,2,4
47,73158,1720138,18,29,1995,9,male,454.0,202,75,0,0,0,0,0,0
48,56709,1161586,110,23,1903,2,female,2232.0,105,30,12,85,12,33,0,52
49,88418,1084227,108,26,1905,3,male,1786.0,415,334,18,1,18,0,0,1
50,59149,1623216,27,19,1986,1,female,346.0,114,77,795,561,795,207,0,354
51,75865,2124779,17,30,1996,1,male,876.0,217,156,111,94,42,19,69,75
52,805,1576850,27,1,1986,1,male,91.0,0,0,0,0,0,0,0,0
53,77100,2175931,16,8,1997,9,female,155.0,222,107,1206,425,837,297,369,128
54,28645,1862611,20,2,1993,7,female,352.0,38,15,1,0,1,0,0,0
55,50513,1095220,39,29,1974,5,male,304.0,87,59,1,0,1,0,0,0
56,19914,1725109,50,1,1963,7,male,369.0,24,17,0,2,0,2,0,0
57,46243,1077551,18,31,1995,10,female,289.0,73,32,620,240,615,190,5,50
58,33320,1684045,47,3,1966,3,female,61.0,44,37,124,77,124,73,0,4
59,91652,2115626,17,10,1996,5,male,411.0,553,396,174,38,4,8,170,30
60,44053,2140977,66,14,1947,6,female,767.0,67,14,75,30,66,17,9,13
61,89770,1713701,103,5,1910,1,male,900.0,471,319,206,385,134,266,72,119
62,96265,1022331,25,1,1988,2,male,684.0,1104,903,31,297,31,270,0,27
63,42680,1383780,102,27,1911,2,male,874.0,65,16,1,1,1,0,0,1
64,29511,1552825,23,8,1990,12,male,458.0,39,12,0,0,0,0,0,0
65,25952,2083828,21,4,1992,5,female,633.0,32,11,11,3,11,2,0,1
66,83660,1317841,17,15,1996,7,male,789.0,304,196,71,3,41,1,30,2
67,88217,2167318,24,2,1989,6,male,507.0,419,360,1,6,1,5,0,1
68,30314,1428103,63,16,1950,2,male,1241.0,40,30,0,0,0,0,0,0
69,72938,1571011,24,5,1989,5,female,291.0,191,137,191,56,74,18,117,38
70,86097,1350183,33,24,1980,9,female,910.0,358,99,2132,2110,1314,1433,818,677
71,66326,2050299,26,26,1987,10,female,743.0,152,120,0,0,0,0,0,0
72,30338,1792167,78,29,1935,9,male,1197.0,40,24,0,2,0,1,0,1
73,62722,2132298,24,20,1989,11,male,59.0,132,99,22,2,4,1,18,1
74,70354,1021579,28,17,1985,2,male,407.0,181,56,2,0,2,0,0,0
75,17548,1522825,56,2,1957,4,male,290.0,20,12,72,58,57,38,15,20
76,14710,1775303,26,16,1987,6,male,95.0,17,7,1,0,0,0,1,0
77,13937,1335645,62,1,1951,1,male,919.0,15,10,3,3,0,1,3,2
78,73588,1355177,103,28,1910,9,male,1207.0,198,132,27,38,27,34,0,4
79,66311,1779526,24,5,1989,8,male,333.0,154,100,0,0,0,0,0,0
80,24648,1586129,49,19,1964,7,male,421.0,31,19,0,0,0,0,0,0
81,96516,1383825,20,27,1993,10,male,480.0,1105,929,230,127,184,91,46,36
82,91592,1551169,98,19,1915,2,male,1586.0,562,281,124,108,123,76,1,32
83,62106,1688750,28,19,1985,4,female,372.0,129,56,303,89,303,81,0,8
84,63232,1882999,13,11,2000,5,male,163.0,135,130,0,0,0,0,0,0
85,25753,1048803,23,11,1990,10,male,330.0,32,11,4,5,0,3,4,2
86,69921,1719083,50,19,1963,5,male,431.0,173,111,135,45,135,32,0,13
87,84275,2186238,16,30,1997,11,male,637.0,333,199,2,0,2,0,0,0
88,5477,1320563,18,5,1995,4,female,133.0,3,3,2,0,0,0,2,0
89,36796,2086049,31,1,1982,5,male,154.0,52,34,2,4,2,2,0,2
90,86367,2085156,26,6,1987,6,female,518.0,381,154,9,26,9,11,0,15
91,83518,1799418,40,2,1973,12,male,484.0,313,116,26,109,26,62,0,47
92,61655,1766880,38,23,1975,5,male,388.0,125,92,18,0,15,0,3,0
93,53166,1308130,16,8,1997,1,male,25.0,97,64,0,0,0,0,0,0
94,48093,1468786,53,25,1960,12,female,250.0,78,34,101,2,0,1,101,1
95,86936,2152224,24,9,1989,8,female,410.0,363,165,432,158,427,131,5,27
96,23440,1929700,55,20,1958,5,male,123.0,30,14,0,0,0,0,0,0
97,38878,1214393,18,1,1995,1,male,189.0,57,53,23,17,23,10,0,7
98,26590,1541995,27,22,1986,8,male,420.0,34,32,0,0,0,0,0,0
99,43683,1748818,27,22,1986,3,male,328.0,68,55,3,0,3,0,0,0
100,79581,1908189,88,15,1925,3,male,1863.0,259,83,32,67,0,21,32,46
101,29652,1054078,48,17,1965,3,female,719.0,39,25,1,3,0,2,1,1
102,49874,1610268,24,23,1989,7,male,415.0,82,53,21,4,21,3,0,1
103,98807,1001431,18,28,1995,6,female,1249.0,2843,828,1679,5765,1359,4106,320,1659
104,36426,2013086,108,22,1905,5,female,107.0,51,27,526,25,468,13,58,12
105,14764,1172185,28,17,1985,10,male,500.0,16,7,1,0,1,0,0,0
106,21338,1120528,29,6,1984,11,female,461.0,26,14,0,1,0,0,0,1
107,87501,1664073,70,14,1943,1,,1849.0,402,210,32,6,32,4,0,2
108,4231,1239609,37,14,1976,7,male,36.0,2,1,0,0,0,0,0,0
109,21605,2010326,59,13,1954,2,female,754.0,26,12,1,5,0,2,1,3
110,62640,1924219,56,6,1957,3,male,775.0,132,94,13,8,0,5,13,3
111,9455,1161931,17,28,1996,10,male,258.0,10,7,0,0,0,0,0,0
112,93899,1411272,24,5,1989,6,female,365.0,652,225,758,736,752,293,6,443
113,76696,1749037,54,7,1959,8,male,1529.0,224,112,45,74,45,51,0,23
114,26293,1469381,21,30,1992,5,male,189.0,32,21,73,3,73,3,0,0
115,43138,1367535,58,1,1955,5,male,21.0,66,14,49,35,49,28,0,7
116,29385,1655784,54,5,1959,7,female,439.0,37,25,167,136,154,116,13,20
117,22323,1549334,26,16,1987,6,female,1322.0,26,17,73,34,3,8,70,26
118,78804,2188934,23,27,1990,4,male,279.0,242,169,113,411,63,294,50,117
119,10644,1558392,55,24,1958,2,female,141.0,9,4,20,10,20,9,0,1
120,21885,1051874,39,11,1974,12,female,347.0,27,15,5,6,1,0,4,6
121,61218,1166556,23,16,1990,2,male,385.0,126,86,0,0,0,0,0,0
122,47740,1423114,18,29,1995,3,male,193.0,77,67,3,0,2,0,1,0
123,49342,1016409,21,27,1992,5,male,140.0,84,69,0,0,0,0,0,0
124,94308,1630995,108,1,1905,2,male,1021.0,759,420,25,21,8,4,17,17
125,68329,1874732,27,7,1986,5,male,893.0,164,73,1,0,0,0,1,0
126,38725,2006780,23,11,1990,11,male,713.0,57,38,7,10,2,3,5,7
127,88883,1053633,108,31,1905,12,male,9.0,435,423,321,114,3,79,318,35
128,24998,1724300,16,1,1997,10,male,401.0,31,18,31,6,0,1,31,5
129,54648,1545648,42,23,1971,4,male,397.0,99,54,4,63,4,42,0,21
130,78537,1038792,24,5,1989,8,male,1318.0,243,108,17,25,17,13,0,12
131,56078,1462650,75,15,1938,7,male,2326.0,101,14,111,5,68,2,43,3
132,70973,2180971,56,18,1957,2,female,1406.0,177,50,214,625,214,255,0,370
133,15274,1271354,27,21,1986,11,male,23.0,16,15,18,8,18,8,0,0
134,10514,2158381,108,1,1905,1,female,202.0,9,4,9,5,7,3,2,2
135,88038,1875649,16,25,1997,12,female,290.0,394,138,1103,730,1002,406,101,324
136,26502,1222442,19,31,1994,8,male,902.0,34,1,0,0,0,0,0,0
137,85309,1353468,20,6,1993,12,male,585.0,342,271,4,189,4,118,0,71
138,5657,2177154,47,20,1966,9,male,194.0,3,2,15,11,0,9,15,2
139,33217,1960143,59,25,1954,7,female,1619.0,44,20,52,13,50,10,2,3
140,59740,2047214,21,25,1992,7,male,462.0,116,73,17,14,4,9,13,5
141,10591,1974761,43,16,1970,6,male,185.0,10,7,14,3,14,0,0,3
142,63369,1820374,64,11,1949,3,male,938.0,139,96,0,0,0,0,0,0
143,7535,1940422,26,23,1987,3,female,558.0,6,5,0,1,0,1,0,0
144,17484,1790446,34,11,1979,3,male,331.0,19,9,45,24,0,6,45,18
145,39901,1289716,38,6,1975,3,male,300.0,58,15,53,31,30,6,23,25
146,6742,1939202,35,17,1978,10,male,300.0,5,4,0,0,0,0,0,0
147,6114,1042283,53,23,1960,2,male,421.0,4,3,0,0,0,0,0,0
148,41198,2054391,28,10,1985,6,female,543.0,63,32,0,0,0,0,0,0
149,27923,1470489,26,9,1987,5,male,159.0,36,33,2,4,2,4,0,0
150,50965,1349803,26,19,1987,7,female,84.0,85,77,43,17,23,8,20,9
151,69593,1382340,25,13,1988,12,male,151.0,175,111,13,36,13,26,0,10
152,55597,1822531,25,1,1988,5,male,40.0,104,101,4,4,4,4,0,0
153,65569,1374054,39,1,1974,1,male,252.0,150,141,10,1,0,1,10,0
154,40508,2000572,27,25,1986,8,female,158.0,60,43,7,0,7,0,0,0
155,64210,1441803,50,8,1963,10,female,150.0,138,87,2104,360,2104,226,0,134
156,79796,1921179,90,6,1923,12,male,1127.0,252,211,124,29,0,16,124,13
157,42587,1797938,38,2,1975,12,male,437.0,66,49,0,1,0,0,0,1
158,49776,1768088,71,31,1942,7,female,1393.0,83,40,12,181,0,127,12,54
159,19838,1198709,26,4,1987,4,male,336.0,24,20,0,1,0,1,0,0
160,35285,1827357,73,30,1940,5,female,1151.0,49,20,84,32,84,19,0,13
161,82248,1635931,25,11,1988,5,male,139.0,290,277,1,11,1,8,0,3
162,50759,1418936,70,1,1943,10,female,1518.0,85,41,11,5,11,5,0,0
163,8217,1985032,23,17,1990,5,female,207.0,7,6,3,0,2,0,1,0
164,40023,1557897,28,16,1985,1,male,267.0,58,46,172,35,159,8,13,27
165,31819,2025028,41,18,1972,3,female,489.0,43,34,6,6,4,1,2,5
166,24454,1428275,68,13,1945,11,female,720.0,29,15,270,52,11,25,259,27
167,44978,2134819,22,5,1991,1,male,522.0,69,7,184,91,116,44,68,47
168,22359,2022446,63,16,1950,11,female,603.0,26,16,104,2,104,2,0,0
169,10541,1844335,20,16,1993,6,female,8.0,9,7,10,1,10,1,0,0
170,50086,1481790,22,10,1991,10,female,595.0,82,42,90,32,90,30,0,2
171,26980,2115682,20,16,1993,11,female,10.0,35,25,2,7,2,5,0,2
172,18854,1615256,36,18,1977,7,male,608.0,23,13,1,0,1,0,0,0
173,12605,1531349,59,3,1954,11,male,422.0,13,5,0,0,0,0,0,0
174,19611,1972756,56,10,1957,9,male,857.0,23,7,79,34,0,0,79,34
175,22591,1165527,42,1,1971,1,male,228.0,28,13,0,0,0,0,0,0
176,19643,1684470,19,1,1994,1,female,113.0,22,13,99,50,87,27,12,23
177,13174,1619041,23,11,1990,10,male,1695.0,14,12,10,0,6,0,4,0
178,72432,1174645,22,2,1991,5,female,671.0,191,81,4,0,0,0,4,0
179,75884,2023459,66,2,1947,12,male,880.0,221,158,122,42,111,37,11,5
180,72696,1997073,34,23,1979,9,female,1188.0,192,149,38,63,38,49,0,14
181,9776,2055639,34,29,1979,4,male,281.0,10,7,0,0,0,0,0,0
182,929,1041387,29,12,1984,6,male,142.0,0,0,0,0,0,0,0,0
183,87934,1415540,24,23,1989,1,female,890.0,390,235,481,552,481,493,0,59
184,76823,1847656,18,4,1995,1,male,294.0,230,125,92,71,92,53,0,18
185,68160,1931753,63,30,1950,5,female,308.0,160,140,948,371,948,182,0,189
186,45445,1369530,43,12,1970,12,male,326.0,73,58,2,3,2,2,0,1
187,4124,1297069,31,1,1982,1,male,546.0,2,0,0,0,0,0,0,0
188,27595,1978693,41,3,1972,11,female,318.0,35,7,145,96,145,83,0,13
189,77743,1267305,85,8,1928,11,female,279.0,235,164,69,12,0,2,69,10
190,11549,2162395,18,12,1995,2,male,40.0,12,9,0,0,0,0,0,0
191,28890,2021089,31,26,1982,6,male,70.0,38,35,5,7,5,7,0,0
192,57615,1538769,108,30,1905,11,male,217.0,111,81,10,18,3,8,7,10
193,30301,1870642,55,28,1958,3,female,882.0,41,24,0,4,0,4,0,0
194,76718,1160275,27,19,1986,1,male,721.0,225,71,53,487,52,352,1,135
195,60815,1713951,54,2,1959,8,male,504.0,124,44,41,7,41,1,0,6
196,26521,1832688,22,31,1991,5,female,352.0,34,22,0,0,0,0,0,0
197,7794,1495882,45,4,1968,4,male,163.0,6,4,0,0,0,0,0,0
198,2194,1838133,22,13,1991,11,female,412.0,1,1,0,1,0,0,0,1
199,56504,1573074,69,29,1944,2,female,386.0,105,67,1,0,1,0,0,0
200,33059,1019176,43,17,1970,6,female,121.0,44,30,19,20,0,4,19,16
201,28867,1032468,63,8,1950,6,male,776.0,37,23,5,0,0,0,5,0
202,7240,1024495,32,30,1981,4,female,473.0,5,4,32,17,10,3,22,14
203,36119,1041321,26,1,1987,1,female,289.0,51,39,29,14,17,5,12,9
204,67122,1009194,59,12,1954,11,female,1243.0,156,104,305,296,25,101,280,195
205,14214,1334019,16,17,1997,6,male,67.0,15,12,106,42,6,14,100,28
206,88828,1694165,25,7,1988,11,female,390.0,436,334,234,185,234,157,0,28
207,52309,1955430,23,27,1990,8,female,137.0,92,31,0,0,0,0,0,0
208,57618,1844433,34,21,1979,1,male,1112.0,110,56,10,5,10,4,0,1
209,86371,1546189,20,15,1993,7,male,432.0,372,302,10,6,0,0,10,6
210,76930,2021494,14,16,1999,11,female,512.0,224,180,218,6,155,2,63,4
211,13291,1441413,32,24,1981,3,male,520.0,13,11,19,2,13,2,6,0
212,47473,1894649,46,20,1967,1,male,405.0,76,41,2066,674,2066,587,0,87
213,84553,1337018,18,7,1995,8,female,114.0,336,100,33,214,29,137,4,77
214,38552,1234739,26,11,1987,1,male,465.0,56,23,1,2,1,1,0,1
215,20238,1483494,34,31,1979,1,female,315.0,24,18,9,4,0,1,9,3
216,65554,1813262,19,14,1994,7,male,1291.0,149,103,8,6,8,5,0,1
217,84539,1233401,20,28,1993,4,male,586.0,327,220,29,70,29,55,0,15
218,97573,2181868,24,19,1989,5,female,1448.0,1444,859,373,354,247,194,126,160
219,73069,1273775,49,29,1964,10,female,1095.0,194,53,729,1226,698,802,31,424
220,69934,1609927,102,1,1911,1,female,1597.0,170,104,155,81,2,19,153,62
221,27518,1836300,58,5,1955,8,male,1519.0,34,11,69,2,0,0,69,2
222,75897,1416357,45,28,1968,10,female,646.0,216,121,131,289,28,61,103,228
223,82417,1460365,13,2,2000,3,female,133.0,296,153,11,5,11,3,0,2
224,95640,2040778,94,12,1919,10,male,1317.0,871,436,315,96,315,77,0,19
225,56880,1693432,19,24,1994,7,female,136.0,107,86,49,9,47,8,2,1
226,67464,1220891,68,17,1945,8,male,1034.0,162,125,2,26,2,22,0,4
227,52033,1107079,49,9,1964,10,female,573.0,90,46,91,201,0,97,91,104
228,89641,2087567,33,16,1980,4,male,615.0,453,246,95,85,94,52,1,33
229,17918,1646481,17,11,1996,4,male,147.0,21,8,1,0,1,0,0,0
230,49352,1233705,22,27,1991,7,male,247.0,83,51,0,18,0,12,0,6
231,97052,1303970,108,1,1905,11,female,1138.0,1727,581,0,26,0,20,0,6
232,20009,1744369,53,13,1960,6,male,332.0,24,20,1,0,1,0,0,0
233,64827,1567225,36,7,1977,9,female,161.0,144,88,55,18,41,3,14,15
234,84453,1584403,28,17,1985,9,male,451.0,324,242,15,24,15,5,0,19
235,22239,1552449,25,3,1988,6,male,31.0,26,18,35,38,34,26,1,12
236,4627,1414891,26,1,1987,1,male,606.0,2,2,2,1,2,1,0,0
237,19704,1708100,25,1,1988,1,female,89.0,22,11,196,71,196,60,0,11
238,17455,1342363,49,13,1964,11,male,594.0,20,18,36,0,36,0,0,0
239,73582,1244646,20,20,1993,4,male,317.0,201,152,26,23,26,22,0,1
240,2989,1058991,48,26,1965,10,male,1030.0,1,1,0,0,0,0,0,0
241,64324,1543599,29,4,1984,1,male,745.0,144,70,0,0,0,0,0,0
242,5038,2184337,25,1,1988,12,male,61.0,3,3,0,0,0,0,0,0
243,25395,1798731,48,15,1965,3,male,233.0,33,7,0,0,0,0,0,0
244,32547,1566117,33,26,1980,2,female,421.0,45,44,0,1,0,1,0,0
245,93123,1082136,103,4,1910,3,male,638.0,663,320,0,5,0,5,0,0
246,57703,1284615,52,9,1961,1,female,1649.0,109,51,19,12,19,9,0,3
247,1675,1829471,74,14,1939,12,male,541.0,0,0,0,0,0,0,0,0
248,29903,1887342,28,20,1985,3,female,109.0,39,27,27,45,27,36,0,9
249,13708,1152246,35,24,1978,4,male,676.0,15,9,0,0,0,0,0,0
250,26375,1582325,59,3,1954,9,female,219.0,33,17,160,12,0,10,160,2
251,85471,1438957,21,16,1992,8,female,433.0,351,196,22,93,7,32,15,61
252,98386,1738053,18,30,1995,11,female,353.0,2022,1144,241,131,147,50,94,81
253,66558,1984646,19,16,1994,2,male,397.0,155,101,7,3,0,1,7,2
254,46968,1005313,20,14,1993,1,male,332.0,75,50,19,0,19,0,0,0
255,41793,1429527,26,9,1987,7,female,280.0,63,43,12,252,12,195,0,57
256,76644,1326398,23,20,1990,7,male,557.0,230,101,32,67,32,60,0,7
257,56091,1072434,100,15,1913,6,female,1758.0,101,62,114,64,95,38,19,26
258,89606,1833683,24,18,1989,11,female,1080.0,446,171,72,52,33,25,39,27
259,35143,1922014,47,1,1966,2,female,253.0,48,35,32,5,0,2,32,3
260,92919,1464691,18,11,1995,2,male,1047.0,605,328,793,361,790,178,3,183
261,51439,1603781,26,26,1987,8,male,291.0,88,72,1,8,0,0,1,8
262,53631,1023085,20,11,1993,11,female,499.0,94,32,8,18,5,17,3,1
263,50939,1021952,31,31,1982,1,male,698.0,87,23,36,53,36,46,0,7
264,68617,1025001,113,12,1900,7,female,1250.0,167,50,13,28,13,9,0,19
265,66101,1400181,37,9,1976,10,female,934.0,145,67,261,384,261,265,0,119
266,9853,1777219,44,12,1969,12,male,329.0,10,5,0,0,0,0,0,0
267,88703,1079920,19,1,1994,7,female,542.0,425,287,123,73,84,26,39,47
268,33592,1115983,33,29,1980,8,female,434.0,47,28,0,1,0,0,0,1
269,47693,1296450,35,8,1978,1,female,263.0,78,53,1,2,1,1,0,1
270,78139,1569359,33,13,1980,1,female,1109.0,233,101,1654,1628,1646,495,8,1133
271,66490,1857758,22,19,1991,11,male,286.0,156,126,3,25,3,9,0,16
272,48186,1077347,26,11,1987,6,female,404.0,78,49,325,122,325,84,0,38
273,85630,1116749,20,21,1993,10,female,473.0,341,166,62,34,7,5,55,29
274,26715,1938103,53,24,1960,8,male,300.0,34,32,0,0,0,0,0,0
275,73405,2153150,18,13,1995,6,female,389.0,198,120,6,83,6,52,0,31
276,5911,1794843,24,30,1989,8,female,228.0,4,2,0,0,0,0,0,0
277,42263,1532004,23,3,1990,8,female,202.0,63,16,122,266,83,190,39,76
278,94375,1007777,24,3,1989,8,male,1748.0,754,399,45,163,25,115,20,48
279,41083,1197265,18,11,1995,5,male,152.0,64,42,0,0,0,0,0,0
280,48069,1068578,35,1,1978,1,male,123.0,78,59,76,23,76,22,0,1
281,97118,2004258,18,12,1995,12,male,721.0,1905,1810,7,2,0,1,7,1
282,74059,1080149,49,8,1964,12,female,1487.0,203,133,1441,371,1441,202,0,169
283,91195,1747308,101,7,1912,6,male,538.0,554,477,2,29,2,27,0,2
284,65333,1944961,98,19,1915,6,male,739.0,145,93,1,2,0,2,1,0
285,19858,1577696,30,13,1983,5,male,364.0,24,8,0,0,0,0,0,0
286,18221,1778356,50,22,1963,7,male,33.0,21,12,23,4,23,2,0,2
287,19888,1229705,40,27,1973,10,female,322.0,24,16,0,0,0,0,0,0
288,32600,1654413,56,11,1957,9,female,508.0,44,36,0,0,0,0,0,0
289,59749,1188607,46,6,1967,4,male,813.0,118,52,19,1,0,0,19,1
290,618,1415074,25,4,1988,1,male,198.0,0,0,0,0,0,0,0,0
291,8440,1598588,23,18,1990,7,male,85.0,7,4,10,7,10,3,0,4
292,51483,1387238,54,24,1959,9,male,284.0,89,76,1,3,1,3,0,0
293,90453,2027774,26,18,1987,8,male,338.0,518,474,38,0,38,0,0,0
294,25323,2046117,30,9,1983,5,male,282.0,33,32,0,4,0,3,0,1
295,24957,2190524,20,28,1993,6,male,100.0,31,22,20,2,20,1,0,1
296,60963,1743336,19,5,1994,12,male,308.0,121,71,124,47,124,45,0,2
297,45762,1474990,44,3,1969,3,male,918.0,73,38,18,13,18,12,0,1
298,45718,2101703,26,7,1987,7,male,643.0,73,55,14,22,14,11,0,11
299,15136,1306288,20,8,1993,12,female,420.0,16,15,8,8,8,6,0,2
300,93337,1269694,16,6,1997,4,female,530.0,647,353,26,46,26,45,0,1
301,23539,2110358,102,11,1911,11,male,1460.0,29,20,1,0,0,0,1,0
302,54580,1866047,100,9,1913,1,male,420.0,98,82,2,5,2,3,0,2
303,2021,1433655,16,1,1997,1,male,10.0,1,1,0,0,0,0,0,0
304,70642,2139556,19,23,1994,5,male,116.0,176,149,22,35,22,26,0,9
305,34056,1747529,21,25,1992,9,male,202.0,46,29,14,19,14,13,0,6
306,49494,1514759,22,9,1991,4,male,480.0,82,75,1,0,1,0,0,0
307,13443,1435777,42,15,1971,7,female,381.0,13,12,54,1,54,0,0,1
308,50341,1152546,22,25,1991,12,male,491.0,87,46,0,0,0,0,0,0
309,87631,1634478,65,25,1948,7,male,606.0,401,305,74,20,19,5,55,15
310,65770,1225402,49,6,1964,6,female,576.0,146,108,36,6,14,2,22,4
311,63620,1603887,28,25,1985,12,male,430.0,136,67,9,7,9,7,0,0
312,64076,1730244,108,13,1905,9,female,1865.0,139,95,251,184,214,112,37,72
313,80869,1717229,19,6,1994,11,male,604.0,268,166,159,97,159,43,0,54
314,49112,1695726,16,10,1997,10,female,35.0,80,52,141,141,115,74,26,67
315,13999,1171785,24,4,1989,4,female,18.0,15,15,4,10,4,8,0,2
316,21310,2127276,27,22,1986,12,male,22.0,27,24,0,0,0,0,0,0
317,37311,1500733,18,18,1995,7,female,47.0,53,33,141,69,141,60,0,9
318,41659,1791433,108,1,1905,1,female,1465.0,62,19,6,1,3,1,3,0
319,59554,1300375,54,24,1959,6,female,200.0,118,109,5,14,0,11,5,3
320,97774,1800069,15,12,1998,3,female,1673.0,1871,835,1029,2375,491,1927,538,448
321,52751,1398461,31,28,1982,12,female,578.0,93,55,21,98,18,88,3,10
322,7206,1784414,17,11,1996,10,female,278.0,5,4,18,0,0,0,18,0
323,64714,1525571,22,8,1991,11,male,672.0,140,43,23,13,23,11,0,2
324,82734,1775153,53,14,1960,1,female,1858.0,299,144,91,122,39,74,52,48
325,76311,2145083,22,15,1991,3,male,155.0,222,203,1,6,1,6,0,0
326,33297,1306320,24,14,1989,8,female,520.0,44,30,101,152,2,21,99,131
327,12597,2162872,58,16,1955,12,female,284.0,13,13,0,1,0,0,0,1
328,20300,1516839,14,4,1999,10,male,10.0,24,20,16,1,0,0,16,1
329,80781,2094738,34,2,1979,10,female,586.0,266,148,98,92,13,7,85,85
330,83519,1453944,91,31,1922,10,female,1080.0,304,135,27,160,3,36,24,124
331,5105,1398730,26,10,1987,10,male,379.0,3,3,0,0,0,0,0,0
332,92097,1114428,30,14,1983,9,female,1125.0,610,493,0,0,0,0,0,0
333,60847,1219537,64,14,1949,8,female,1681.0,121,91,53,44,11,9,42,35
334,11164,1781729,49,22,1964,10,male,312.0,11,4,1,0,1,0,0,0
335,98761,1762561,28,14,1985,8,male,1193.0,2416,745,1425,10257,723,4306,702,5951
336,15188,1859236,26,16,1987,3,male,341.0,16,10,11,2,11,0,0,2
337,33596,1533052,36,11,1977,11,male,445.0,47,36,0,15,0,10,0,5
338,98575,2022668,16,25,1997,2,male,804.0,2072,1498,626,565,269,429,357,136
339,79137,1956225,19,1,1994,1,male,639.0,258,194,0,3,0,2,0,1
340,37041,1398363,51,5,1962,7,female,111.0,53,34,16,62,6,45,10,17
341,46159,2179641,24,23,1989,1,female,90.0,72,42,228,193,102,108,126,85
342,30690,1828745,46,5,1967,5,male,270.0,41,27,7,2,7,1,0,1
343,34721,1064620,108,19,1905,6,male,94.0,48,14,1,8,0,4,1,4
344,82142,1353881,20,28,1993,12,male,267.0,291,272,0,4,0,4,0,0
345,70958,1176980,54,5,1959,6,female,702.0,176,84,191,190,191,95,0,95
346,95808,1204594,21,13,1992,6,female,846.0,883,297,835,1563,248,639,587,924
347,75367,1974181,41,27,1972,4,male,575.0,218,91,4,9,4,4,0,5
348,92266,1258336,18,22,1995,5,male,441.0,579,494,13,34,4,14,9,20
349,91399,1366968,16,13,1997,3,female,410.0,537,398,33,4,21,3,12,1
350,82651,1862682,20,23,1993,8,male,370.0,302,281,55,5,55,5,0,0
351,33504,1135009,22,18,1991,6,male,821.0,46,33,0,0,0,0,0,0
352,47802,2025884,22,4,1991,10,male,52.0,78,40,6,5,6,5,0,0
353,87996,1048543,23,16,1990,11,male,1658.0,382,193,730,647,388,471,342,176
354,92301,1118915,102,20,1911,10,female,1785.0,596,231,17,53,17,39,0,14
355,29897,1904625,53,29,1960,7,female,554.0,39,28,26,18,23,18,3,0
356,51326,2110153,20,1,1993,10,male,100.0,89,74,0,0,0,0,0,0
357,92100,1797791,44,14,1969,5,male,427.0,621,453,0,0,0,0,0,0
358,86966,1149147,63,5,1950,12,female,360.0,367,316,515,516,11,160,504,356
359,84920,1814417,50,18,1963,2,female,1794.0,325,228,411,382,54,27,357,355
360,94368,1060864,77,7,1936,3,female,43.0,744,359,44,8,10,6,34,2
361,13481,2037263,55,30,1958,9,male,368.0,13,9,84,60,30,46,54,14
362,33265,1345433,44,12,1969,10,male,620.0,44,32,77,1,77,0,0,1
363,68642,1977266,26,13,1987,11,male,198.0,168,2,16,8,16,3,0,5
364,85891,1513805,20,25,1993,2,female,256.0,348,233,265,60,200,50,65,10
365,58086,1482189,65,19,1948,10,female,1877.0,108,43,295,346,243,250,52,96
366,2324,1227162,23,6,1990,6,female,57.0,1,0,0,0,0,0,0,0
367,34753,1672579,22,22,1991,7,female,393.0,48,23,1,2,1,1,0,1
368,8725,1958178,18,11,1995,4,female,159.0,8,6,0,0,0,0,0,0
369,14011,1256759,25,1,1988,1,male,264.0,15,11,5,5,5,5,0,0
370,45341,1469206,28,11,1985,1,male,262.0,73,48,1,0,1,0,0,0
371,82537,1903617,27,15,1986,11,female,295.0,292,175,29,26,21,20,8,6
372,38062,1426978,39,6,1974,8,male,1764.0,55,12,39,14,39,10,0,4
373,78667,1049280,16,14,1997,9,female,516.0,244,88,46,1,3,0,43,1
374,86895,1447584,29,1,1984,2,male,352.0,372,274,323,67,323,66,0,1
375,96955,1002882,23,13,1990,3,male,262.0,1049,874,3532,868,3144,625,388,243
376,72723,1148121,103,3,1910,11,male,751.0,194,136,49,25,49,25,0,0
377,21079,1401082,16,7,1997,11,male,155.0,25,19,74,22,67,11,7,11
378,49921,1622170,47,1,1966,8,male,331.0,83,60,30,1,0,1,30,0
379,47078,1607557,24,27,1989,6,male,536.0,75,64,36,5,33,4,3,1
380,6028,2129172,37,4,1976,1,female,351.0,4,2,0,0,0,0,0,0
381,43586,1512902,25,17,1988,7,male,669.0,68,44,1,0,1,0,0,0
382,93002,2034467,108,8,1905,7,,1651.0,634,454,1362,1886,757,722,605,1164
383,55504,2075207,19,28,1994,2,female,283.0,102,78,2,0,2,0,0,0
384,32550,1114391,35,3,1978,12,male,1180.0,45,22,0,10,0,2,0,8
385,53060,1140058,68,29,1945,12,female,733.0,91,61,224,62,224,39,0,23
386,5565,1535777,42,13,1971,10,male,197.0,3,2,4,3,0,0,4,3
387,94349,1447565,108,30,1905,7,female,1022.0,818,264,38,40,7,11,31,29
388,64077,1185063,59,28,1954,5,female,2305.0,135,65,253,421,190,185,63,236
389,1540,1198595,52,18,1961,10,male,335.0,0,0,0,0,0,0,0,0
390,24738,1327354,60,22,1953,11,male,96.0,31,19,1,3,1,3,0,0
391,20478,1700775,18,19,1995,10,male,594.0,24,21,281,42,277,39,4,3
392,46599,1148531,30,2,1983,1,male,190.0,74,65,1,2,1,1,0,1
393,93653,2110374,17,13,1996,6,female,560.0,665,391,202,299,200,183,2,116
394,76598,1953478,26,13,1987,6,male,491.0,224,207,23,78,23,74,0,4
395,50338,2027406,20,4,1993,9,male,345.0,87,79,0,0,0,0,0,0
396,35644,1475563,59,24,1954,5,female,284.0,50,37,0,1,0,0,0,1
397,43313,1211012,67,16,1946,7,female,1883.0,65,17,283,75,0,7,283,68
398,12533,1509308,43,20,1970,9,male,233.0,14,3,0,1,0,0,0,1
399,55403,1817636,66,12,1947,3,female,1583.0,102,80,0,0,0,0,0,0
400,9680,1123399,28,1,1985,1,male,1162.0,10,6,0,1,0,1,0,0
401,78664,1427545,108,1,1905,1,male,1822.0,243,117,45,133,0,68,45,65
402,32250,1402368,44,20,1969,5,female,498.0,42,13,112,5,83,0,29,5
403,74591,1355906,50,17,1963,3,female,707.0,205,75,26,81,1,33,25,48
404,11052,1768247,53,5,1960,1,male,114.0,11,8,0,0,0,0,0,0
405,92980,1565308,64,1,1949,1,female,1569.0,579,324,1214,1427,226,558,988,869
406,57254,1092706,32,5,1981,7,male,218.0,110,101,0,0,0,0,0,0
407,91929,1399804,51,5,1962,6,female,1366.0,538,311,849,1273,784,851,65,422
408,18404,1126200,19,20,1994,12,male,213.0,23,16,0,0,0,0,0,0
409,73794,1923333,17,3,1996,2,male,315.0,199,53,106,58,106,55,0,3
410,84306,2011578,108,30,1905,12,female,722.0,331,165,3,3,3,1,0,2
411,37813,2152401,26,30,1987,3,male,252.0,55,34,7,2,7,2,0,0
412,84219,1844423,108,1,1905,1,male,2394.0,324,64,0,1,0,1,0,0
413,59196,1262203,15,19,1998,1,male,262.0,117,49,0,0,0,0,0,0
414,90422,1928530,100,13,1913,4,male,2178.0,503,219,30,16,11,8,19,8
415,10498,2073815,26,30,1987,7,male,144.0,9,8,8,3,8,3,0,0
416,50083,2117102,56,5,1957,1,male,339.0,83,62,88,36,40,30,48,6
417,22992,1328385,25,1,1988,1,male,34.0,28,23,33,16,33,12,0,4
418,79454,1278908,18,8,1995,8,male,225.0,259,132,14,15,14,12,0,3
419,86228,1986556,16,23,1997,12,female,160.0,371,220,1,54,1,46,0,8
420,93916,1146791,16,2,1997,2,female,82.0,685,563,870,155,870,117,0,38
421,23336,1348111,34,11,1979,2,female,223.0,29,5,0,1,0,0,0,1
422,81623,1124357,23,22,1990,6,female,623.0,288,165,58,126,35,94,23,32
423,30247,1538279,35,13,1978,11,male,885.0,41,19,0,2,0,2,0,0
424,77568,1929116,13,20,2000,3,female,413.0,235,182,23,15,23,4,0,11
425,35084,1575898,14,15,1999,11,male,386.0,48,24,21,2,5,2,16,0
426,5901,1039052,24,2,1989,3,female,474.0,4,2,0,0,0,0,0,0
427,22617,1560358,59,28,1954,5,male,437.0,28,26,0,0,0,0,0,0
428,69445,1513051,32,20,1981,11,male,1385.0,175,118,3,2,3,2,0,0
429,69358,1644045,26,22,1987,12,female,280.0,173,17,1,0,1,0,0,0
430,35834,1158227,61,13,1952,5,male,1860.0,50,31,4,2,1,2,3,0
431,51671,1596221,25,20,1988,3,male,364.0,90,57,7,17,7,15,0,2
432,54636,2020785,26,9,1987,9,female,482.0,99,46,4,1,4,0,0,1
433,22787,2129966,18,4,1995,8,female,151.0,28,20,4,6,4,5,0,1
434,98328,1838288,20,14,1993,11,female,165.0,1964,99,146,1706,146,1547,0,159
435,15519,1756162,48,23,1965,10,female,258.0,16,7,145,60,145,47,0,13
436,15394,1094638,30,7,1983,12,male,420.0,17,10,48,12,48,7,0,5
437,67093,1997285,15,17,1998,2,male,569.0,151,121,226,0,218,0,8,0
438,31759,1481940,108,1,1905,1,male,2088.0,42,27,4,15,0,7,4,8
439,11598,2035827,23,25,1990,6,female,26.0,12,10,0,0,0,0,0,0
440,40099,1200100,76,10,1937,11,female,569.0,59,34,488,77,488,72,0,5
441,58200,1746806,16,1,1997,2,male,170.0,115,83,0,1,0,0,0,1
442,43728,1898343,29,12,1984,3,male,552.0,67,22,5,2,5,1,0,1
443,7378,1634798,19,1,1994,1,female,119.0,7,0,0,0,0,0,0,0
444,28854,1866925,19,4,1994,9,male,129.0,37,33,4,5,4,4,0,1
445,75397,1885856,23,12,1990,8,male,453.0,220,204,6,2,6,1,0,1
446,16737,1137075,28,26,1985,6,male,854.0,19,18,1,0,0,0,1,0
447,74361,1647704,22,16,1991,6,male,602.0,208,114,4,1,4,0,0,1
448,62499,1952991,52,10,1961,9,female,734.0,134,92,4,69,0,50,4,19
449,92506,1792260,19,11,1994,7,male,588.0,582,414,81,176,81,162,0,14
450,47892,1910052,29,8,1984,1,female,493.0,78,32,15,12,15,7,0,5
451,14223,1188861,54,31,1959,8,female,98.0,15,2,145,12,145,6,0,6
452,1599,1136585,60,19,1953,12,male,141.0,0,0,0,0,0,0,0,0
453,45977,1716441,31,24,1982,10,male,302.0,72,55,56,18,56,14,0,4
454,6601,2045622,23,1,1990,1,male,137.0,5,3,0,0,0,0,0,0
455,28419,1140257,25,18,1988,4,female,426.0,38,16,0,0,0,0,0,0
456,26474,1643848,16,15,1997,3,male,374.0,34,27,0,1,0,0,0,1
457,31552,2138882,66,17,1947,3,male,426.0,42,15,1,2,0,1,1,1
458,3479,1825535,25,8,1988,7,female,485.0,1,1,5,2,0,0,5,2
459,2607,1315675,31,13,1982,12,male,248.0,1,0,0,0,0,0,0,0
460,6261,2084761,23,30,1990,1,male,217.0,4,4,2,0,0,0,2,0
461,66239,1068267,30,28,1983,3,male,567.0,147,78,3229,280,3229,244,0,36
462,21015,1480273,20,8,1993,12,male,76.0,25,11,30,7,30,2,0,5
463,91914,1057523,20,22,1993,6,female,1545.0,542,229,795,1066,742,983,53,83
464,25014,1032744,41,17,1972,8,female,279.0,31,13,37,5,11,1,26,4
465,15320,1362632,16,4,1997,8,male,297.0,16,14,27,4,0,3,27,1
466,86580,2001137,21,25,1992,5,female,522.0,367,236,49,49,49,36,0,13
467,31566,1083945,19,20,1994,8,male,481.0,42,12,1,0,1,0,0,0
468,22971,1248723,36,21,1977,11,female,50.0,28,24,28,27,2,3,26,24
469,60447,1751271,16,17,1997,4,male,183.0,123,55,1,2,1,2,0,0
470,98465,1208130,103,11,1910,3,male,2094.0,4501,583,365,743,335,329,30,414
471,49460,1245869,75,31,1938,8,female,1808.0,83,26,0,1,0,1,0,0
472,14155,1433316,35,4,1978,5,male,1346.0,15,10,36,4,7,4,29,0
473,77131,1204088,28,11,1985,11,female,601.0,225,54,2462,736,2462,636,0,100
474,35090,1140701,29,13,1984,4,male,315.0,49,25,21,19,21,16,0,3
475,56553,2156498,27,11,1986,7,male,689.0,106,73,2,1,2,1,0,0
476,82924,1584322,28,30,1985,1,male,466.0,289,229,310,928,50,460,260,468
477,94907,1866690,18,7,1995,1,female,208.0,766,340,1057,1925,459,580,598,1345
478,75964,1948895,18,4,1995,3,male,281.0,217,184,196,20,196,18,0,2
479,41416,1561360,69,23,1944,8,male,1213.0,64,25,1,1,1,1,0,0
480,76087,2113316,66,19,1947,3,female,1322.0,219,49,588,144,20,75,568,69
481,86198,1546261,45,30,1968,6,male,839.0,370,222,0,1,0,1,0,0
482,48931,1719744,39,10,1974,5,male,915.0,80,61,41,66,36,35,5,31
483,30505,1812544,24,9,1989,12,male,254.0,41,17,2,8,2,7,0,1
484,74784,1301003,18,20,1995,11,male,246.0,209,83,88,33,88,26,0,7
485,24031,1653112,19,19,1994,7,female,183.0,30,11,14,15,14,11,0,4
486,49797,1162730,58,28,1955,8,female,1712.0,84,33,13,30,13,6,0,24
487,5875,1302660,22,1,1991,6,male,214.0,4,3,0,0,0,0,0,0
488,97638,1664530,24,7,1989,4,female,526.0,1390,603,552,1242,1,661,551,581
489,42333,1302111,41,13,1972,7,female,91.0,63,11,201,75,104,66,97,9
490,70241,1228497,30,12,1983,3,male,527.0,182,118,0,0,0,0,0,0
491,61907,2087538,36,7,1977,1,male,532.0,126,71,83,130,70,57,13,73
492,29558,1166356,29,23,1984,1,male,372.0,39,26,0,22,0,7,0,15
493,19387,1066019,68,17,1945,8,female,593.0,23,15,18,36,3,26,15,10
494,73665,2000866,64,11,1949,1,female,1913.0,198,67,43,132,42,72,1,60
495,95094,1846954,20,11,1993,5,female,273.0,867,186,1,16,1,12,0,4
496,31840,2155590,31,5,1982,9,female,477.0,43,27,7,43,6,26,1,17
497,46557,1022263,27,11,1986,5,female,506.0,76,50,1,0,1,0,0,0
498,82010,2037168,25,9,1988,5,male,1166.0,287,170,597,95,592,53,5,42
499,79528,1801872,16,9,1997,7,male,386.0,254,156,25,75,25,25,0,50
500,12844,1976948,67,3,1946,2,male,1020.0,13,8,2,0,0,0,2,0
501,16138,2183728,22,14,1991,1,female,247.0,18,13,21,11,0,7,21,4
502,91494,1891356,23,17,1990,7,male,1445.0,539,330,62,266,62,232,0,34
503,25650,2047475,19,30,1994,7,male,31.0,32,14,2,0,2,0,0,0
504,33348,1906141,45,26,1968,8,male,363.0,44,22,178,291,178,237,0,54
505,70816,1196199,51,18,1962,5,female,841.0,178,37,79,86,79,46,0,40
506,51121,1336361,30,26,1983,9,female,728.0,85,44,133,91,122,41,11,50
507,63475,1377097,65,7,1948,5,female,1139.0,135,45,2,2,2,0,0,2
508,32135,1826249,35,7,1978,4,male,578.0,42,10,45,125,45,96,0,29
509,57228,1136915,25,3,1988,1,male,599.0,110,79,0,0,0,0,0,0
510,94564,1739337,80,19,1933,12,male,347.0,731,268,146,169,146,149,0,20
511,14729,1431654,44,3,1969,6,male,388.0,17,9,1,1,0,0,1,1
512,84765,1152681,20,6,1993,5,male,390.0,335,126,133,391,14,135,119,256
513,52377,2012094,49,21,1964,5,female,430.0,92,33,0,0,0,0,0,0
514,6000,1909143,33,23,1980,1,female,455.0,4,1,0,0,0,0,0,0
515,82789,1483961,18,15,1995,7,male,587.0,293,191,126,179,109,92,17,87
516,79423,1361034,20,2,1993,8,male,637.0,255,65,11,15,3,11,8,4
517,60148,1652333,30,8,1983,12,female,497.0,119,56,278,138,264,79,14,59
518,40755,1314443,46,1,1967,11,female,538.0,60,33,48,29,33,22,15,7
519,46141,1498657,41,4,1972,11,female,625.0,73,48,198,65,0,10,198,55
520,35455,2050988,13,10,2000,2,male,181.0,50,35,0,0,0,0,0,0
521,88316,1174734,14,28,1999,3,female,252.0,418,273,6,2,6,2,0,0
522,44557,1532368,59,7,1954,10,female,677.0,70,40,5,0,0,0,5,0
523,58667,1957832,21,18,1992,11,male,55.0,112,102,17,0,0,0,17,0
524,65143,1973433,16,19,1997,11,male,273.0,146,118,0,0,0,0,0,0
525,59858,1906327,27,29,1986,1,female,297.0,117,40,34,27,34,6,0,21
526,53757,1678612,25,3,1988,2,male,439.0,97,57,16,201,16,153,0,48
527,88509,1016280,20,20,1993,11,male,506.0,421,231,36,46,26,6,10,40
528,59086,1614406,49,21,1964,4,female,38.0,114,61,343,118,343,73,0,45
529,23984,1756358,25,23,1988,7,male,29.0,29,23,11,5,11,4,0,1
530,10331,1751857,21,25,1992,2,female,267.0,10,7,3,3,0,0,3,3
531,26985,1743213,24,6,1989,3,male,745.0,34,8,2,4,2,4,0,0
532,37409,1538989,36,29,1977,1,female,95.0,53,50,1161,191,1128,86,33,105
533,25485,1696245,77,11,1936,8,female,644.0,32,23,0,2,0,2,0,0
534,15576,2020515,15,16,1998,11,male,45.0,18,17,0,0,0,0,0,0
535,47059,1623730,56,15,1957,9,male,770.0,75,29,32,12,0,5,32,7
536,77424,2108058,16,7,1997,9,female,147.0,237,112,7,27,0,16,7,11
537,55892,1600036,27,19,1986,1,male,61.0,101,97,32,15,32,7,0,8
538,52873,1516931,55,4,1958,4,male,346.0,91,72,48,75,48,37,0,38
539,42144,1344002,77,19,1936,10,female,992.0,63,26,65,127,5,57,60,70
540,59834,2161296,48,27,1965,1,male,88.0,120,57,30,102,29,67,1,35
541,79949,1597109,23,26,1990,4,male,314.0,252,134,371,65,308,44,63,21
542,65800,1991915,19,25,1994,9,female,19.0,146,129,41,45,41,22,0,23
543,39560,1025375,42,9,1971,1,male,676.0,58,37,4,4,0,4,4,0
544,88461,1877400,18,14,1995,7,female,250.0,415,178,26,5,1,0,25,5
545,14800,1772167,36,10,1977,1,male,770.0,16,9,1,1,1,0,0,1
546,63235,2058123,14,15,1999,2,male,285.0,136,86,0,0,0,0,0,0
547,36777,1084993,32,3,1981,3,female,247.0,52,47,2,1,2,1,0,0
548,418,1142462,22,18,1991,3,female,644.0,0,0,0,0,0,0,0,0
549,34727,1462583,18,9,1995,9,female,490.0,48,25,1,0,1,0,0,0
550,72114,1928807,49,29,1964,6,female,1584.0,187,100,750,352,667,185,83,167
551,64075,1082765,20,13,1993,9,female,1521.0,137,76,247,336,31,75,216,261
552,27945,2186020,24,18,1989,9,female,40.0,36,30,3,2,3,2,0,0
553,77306,1352111,54,8,1959,2,female,379.0,236,174,1,4,1,4,0,0
554,63972,1482785,62,26,1951,5,female,914.0,137,86,103,139,103,75,0,64
555,51288,1041757,68,14,1945,11,female,123.0,87,17,2000,226,0,97,2000,129
556,20588,1491593,27,29,1986,5,male,731.0,25,1,0,2,0,0,0,2
557,86992,1041558,26,10,1987,7,male,448.0,362,229,593,366,497,199,96,167
558,58992,1951230,18,1,1995,9,female,332.0,112,97,150,191,128,143,22,48
559,21573,1454509,25,10,1988,8,male,223.0,27,16,1,0,0,0,1,0
560,94477,1445005,14,26,1999,11,female,255.0,779,336,94,61,9,36,85,25
561,11388,1564187,68,10,1945,9,male,8.0,11,9,16,17,0,9,16,8
562,33468,1784073,19,1,1994,1,male,259.0,47,28,0,7,0,6,0,1
563,46803,1221843,68,27,1945,11,male,663.0,74,40,6,0,6,0,0,0
564,84941,1523454,19,14,1994,8,female,95.0,336,262,458,1638,162,994,296,644
565,47520,1048477,23,24,1990,9,female,481.0,77,51,0,0,0,0,0,0
566,1699,1579594,19,18,1994,10,male,212.0,0,0,1,0,0,0,1,0
567,10004,1568535,61,18,1952,9,male,487.0,10,5,0,0,0,0,0,0
568,47219,1075530,25,27,1988,1,female,285.0,74,59,79,61,79,24,0,37
569,80788,1315138,19,8,1994,1,female,644.0,271,129,99,17,99,17,0,0
570,78267,1732928,15,28,1998,3,male,426.0,247,174,1,8,0,3,1,5
571,29430,1097823,29,16,1984,6,male,191.0,37,32,331,65,331,28,0,37
572,24949,1237697,50,24,1963,9,male,190.0,31,23,18,32,18,18,0,14
573,325,1083587,20,4,1993,5,male,723.0,0,0,0,0,0,0,0,0
574,47927,1409540,31,13,1982,10,male,78.0,77,65,20,33,20,9,0,24
575,48311,2153222,24,1,1989,2,male,395.0,81,39,0,0,0,0,0,0
576,58902,1840759,14,17,1999,3,female,241.0,112,69,80,44,76,38,4,6
577,49545,2163827,20,18,1993,2,male,305.0,83,60,2,0,0,0,2,0
578,1654,1160934,66,5,1947,6,male,131.0,0,0,0,0,0,0,0,0
579,78586,1959565,100,14,1913,5,male,1038.0,242,162,28,9,28,8,0,1
580,89106,1383221,19,29,1994,10,female,1240.0,436,149,4071,2281,1111,394,2960,1887
581,77135,1184396,53,25,1960,9,female,373.0,225,53,7791,649,7578,462,213,187
582,39652,1409464,23,13,1990,9,female,44.0,58,28,8,106,8,37,0,69
583,11960,1005588,25,1,1988,1,male,40.0,12,10,6,0,6,0,0,0
584,96166,1247603,17,19,1996,8,female,720.0,1053,267,9,153,9,123,0,30
585,18742,1335318,68,8,1945,4,male,17.0,22,20,0,0,0,0,0,0
586,84576,1573593,19,3,1994,2,female,618.0,321,124,38,5,31,2,7,3
587,94974,1327814,17,28,1996,8,male,493.0,780,618,1586,642,1586,431,0,211
588,8722,1445009,18,2,1995,2,male,383.0,8,7,0,0,0,0,0,0
589,77364,1206406,21,25,1992,1,male,631.0,236,127,4,1,0,1,4,0
590,96979,1812645,17,13,1996,6,male,651.0,1222,591,4059,1487,1404,572,2655,915
591,13159,1044539,68,20,1945,2,male,845.0,13,9,9,1,8,1,1,0
592,52328,1241986,25,12,1988,9,male,217.0,92,26,0,0,0,0,0,0
593,57396,2001466,47,17,1966,12,female,287.0,110,64,2,4,0,3,2,1
594,45261,1057366,45,13,1968,12,male,138.0,72,72,0,3,0,3,0,0
595,64812,1916044,108,17,1905,1,female,1900.0,144,114,50,13,0,8,50,5
596,74158,1787657,21,12,1992,6,male,331.0,207,153,0,0,0,0,0,0
597,54731,1139771,17,3,1996,2,male,307.0,99,59,10,1,0,1,10,0
598,80381,1839426,57,15,1956,5,male,905.0,270,106,8,1,2,1,6,0
599,26627,1350750,32,19,1981,2,male,290.0,35,21,0,0,0,0,0,0
600,64692,2074834,19,10,1994,10,male,309.0,142,57,19,2,0,0,19,2
601,47765,2173772,23,30,1990,11,male,705.0,77,2,4,0,4,0,0,0
602,79131,1153000,18,6,1995,6,female,272.0,256,195,0,17,0,10,0,7
603,43460,1002150,24,20,1989,9,male,146.0,67,46,0,0,0,0,0,0
604,86643,1032523,48,21,1965,5,male,690.0,366,307,77,403,8,164,69,239
605,22705,1683489,43,19,1970,2,male,133.0,28,23,1,3,1,3,0,0
606,44508,2123115,23,3,1990,3,female,47.0,69,59,3,0,3,0,0,0
607,24447,1958570,62,25,1951,5,female,1052.0,29,7,225,30,225,27,0,3
608,33713,1302613,26,1,1987,1,male,354.0,46,18,1,0,1,0,0,0
609,1731,1711316,13,9,2000,5,male,40.0,0,0,1,0,1,0,0,0
610,54745,1513399,26,26,1987,3,female,415.0,100,67,11,109,0,15,11,94
611,60264,1789857,38,22,1975,2,female,240.0,119,74,2681,4648,271,1045,2410,3603
612,52630,1261695,24,17,1989,7,male,594.0,93,52,7,1,7,1,0,0
613,65437,1824186,105,29,1908,2,male,1120.0,150,82,3,9,0,2,3,7
614,74843,2114840,108,11,1905,3,female,2251.0,208,97,135,73,10,35,125,38
615,9722,1283418,30,23,1983,2,male,42.0,10,4,0,0,0,0,0,0
616,79332,1186948,16,24,1997,5,male,762.0,261,148,5,0,0,0,5,0
617,7995,1460854,58,6,1955,10,male,593.0,7,2,1,0,0,0,1,0
618,22132,1689856,68,1,1945,2,female,1557.0,27,16,18,2,18,0,0,2
619,85435,2013911,108,31,1905,10,male,943.0,346,300,16,3,1,1,15,2
620,28589,1866440,72,5,1941,7,female,129.0,37,32,0,0,0,0,0,0
621,6369,2164109,63,15,1950,5,male,78.0,4,3,6,2,6,2,0,0
622,9607,1211032,26,24,1987,12,male,65.0,10,9,0,0,0,0,0,0
623,48679,1017901,60,19,1953,3,female,734.0,81,44,8,24,8,17,0,7
624,57253,1789043,33,24,1980,11,male,666.0,109,56,0,3,0,1,0,2
625,84015,2087253,37,22,1976,8,female,1111.0,318,132,560,1164,560,685,0,479
626,85781,1810093,21,7,1992,12,male,1233.0,356,249,139,136,86,67,53,69
627,11073,2174523,59,22,1954,10,female,107.0,11,9,0,0,0,0,0,0
628,23102,1212927,23,26,1990,2,female,160.0,28,22,178,2,178,2,0,0
629,65834,1103372,25,23,1988,12,male,168.0,149,131,49,729,49,674,0,55
630,46795,1838700,73,14,1940,2,female,270.0,74,48,6,17,0,1,6,16
631,63055,1637446,62,15,1951,8,female,687.0,134,80,197,31,79,5,118,26
632,71601,1119040,50,30,1963,7,male,1356.0,184,95,22,10,22,5,0,5
633,39790,1891436,63,2,1950,9,female,145.0,58,27,21,130,21,30,0,100
634,20530,1840439,20,20,1993,5,male,47.0,25,9,0,0,0,0,0,0
635,52929,1029023,22,4,1991,3,male,27.0,93,89,76,73,61,66,15,7
636,96526,1482584,16,20,1997,11,female,521.0,1162,629,241,86,103,45,138,41
637,28833,1426395,21,10,1992,11,male,465.0,38,22,4,2,1,1,3,1
638,2934,1298895,44,12,1969,10,male,298.0,1,0,0,0,0,0,0,0
639,63201,1939788,108,24,1905,8,male,1489.0,132,45,806,775,173,317,633,458
640,89262,1867705,64,2,1949,9,female,965.0,460,176,3,9,0,8,3,1
641,84533,1878839,96,18,1917,7,male,1020.0,333,174,28,36,1,18,27,18
642,56988,2075955,63,3,1950,1,male,498.0,105,72,121,103,121,37,0,66
643,98889,1556932,22,8,1991,1,female,172.0,3055,715,2636,6993,719,1887,1917,5106
644,81437,1890378,25,28,1988,9,male,711.0,280,215,14,34,14,34,0,0
645,74913,2021232,22,15,1991,2,male,437.0,212,114,196,369,196,365,0,4
646,52261,1764337,17,1,1996,8,female,263.0,92,77,0,0,0,0,0,0
647,15240,1221599,59,1,1954,2,male,272.0,16,5,14,18,14,13,0,5
648,86091,1370847,20,30,1993,8,male,537.0,343,130,1651,751,1643,530,8,221
649,29818,1496712,26,11,1987,3,male,380.0,39,31,10,0,0,0,10,0
650,80694,1925975,18,16,1995,11,female,502.0,262,226,59,47,59,46,0,1
651,774,1286949,26,10,1987,7,male,492.0,0,0,0,0,0,0,0,0
652,92658,1406821,22,9,1991,6,male,395.0,602,427,194,648,8,454,186,194
653,49557,2176940,75,8,1938,10,male,635.0,83,18,2,1,1,1,1,0
654,68368,2112950,21,26,1992,9,male,307.0,164,125,1,2,1,1,0,1
655,46477,1154057,50,30,1963,6,female,396.0,74,56,0,0,0,0,0,0
656,314,1783684,20,10,1993,2,female,42.0,0,0,0,0,0,0,0,0
657,31447,1277225,46,1,1967,11,male,412.0,43,22,0,0,0,0,0,0
658,71170,1959957,21,23,1992,12,male,804.0,190,160,0,6,0,3,0,3
659,32727,1195262,22,5,1991,9,male,255.0,45,16,2,4,0,1,2,3
660,83981,1238807,21,21,1992,12,female,1462.0,304,136,478,130,295,51,183,79
661,37456,1413205,19,15,1994,3,female,247.0,54,42,0,2,0,2,0,0
662,38590,1952369,26,19,1987,11,male,209.0,56,23,2,0,2,0,0,0
663,26092,1005598,73,1,1940,1,female,34.0,32,20,23,21,22,14,1,7
664,31513,1751492,92,4,1921,6,male,783.0,43,34,0,4,0,4,0,0
665,81589,1712300,17,2,1996,2,female,67.0,279,63,46,23,46,18,0,5
666,19333,2115650,14,18,1999,5,male,266.0,22,5,13,0,13,0,0,0
667,13926,1217898,22,18,1991,10,male,195.0,15,12,2,7,2,7,0,0
668,83049,1898818,48,6,1965,3,female,533.0,292,220,852,303,0,66,852,237
669,1824,1209426,28,29,1985,12,female,247.0,0,0,3,0,0,0,3,0
670,84922,1396996,54,4,1959,8,female,2123.0,334,187,414,190,102,87,312,103
671,61651,1329871,30,1,1983,2,female,416.0,126,83,17,4,17,1,0,3
672,75270,1872300,18,24,1995,12,male,386.0,213,137,1,53,1,47,0,6
673,46807,1583457,19,12,1994,4,female,261.0,74,29,6,6,6,5,0,1
674,58844,2166843,48,24,1965,9,female,420.0,113,80,53,89,53,20,0,69
675,44587,1081221,26,25,1987,12,male,541.0,70,29,6,21,5,9,1,12
676,85255,2006245,17,18,1996,5,female,340.0,344,80,2,37,2,34,0,3
677,61534,2142052,113,1,1900,1,female,1356.0,125,68,7,1,0,0,7,1
678,21924,1279781,36,17,1977,4,male,259.0,26,16,6,3,6,1,0,2
679,82555,2038150,33,22,1980,5,male,701.0,289,145,32,5,32,2,0,3
680,26975,1077246,34,1,1979,8,male,572.0,35,11,2,2,2,2,0,0
681,67875,1484293,110,10,1903,7,male,2015.0,160,66,83,104,81,66,2,38
682,73767,1617539,14,26,1999,3,female,496.0,200,146,90,0,90,0,0,0
683,6540,1246018,18,16,1995,1,male,334.0,5,3,0,0,0,0,0,0
684,81274,1105238,46,6,1967,2,female,533.0,283,42,2,12,2,6,0,6
685,31257,1279977,14,30,1999,3,male,211.0,42,36,0,0,0,0,0,0
686,3953,1406464,23,9,1990,4,male,603.0,2,0,0,0,0,0,0,0
687,29479,1425208,16,20,1997,7,male,335.0,39,21,0,2,0,1,0,1
688,71559,1186806,22,4,1991,11,female,324.0,184,113,17,161,8,62,9,99
689,67873,2082962,61,21,1952,5,female,1444.0,160,71,82,174,39,149,43,25
690,83999,1725083,25,29,1988,4,male,482.0,317,250,486,219,486,186,0,33
691,341,1142251,20,1,1993,9,female,446.0,0,0,0,0,0,0,0,0
692,52709,1451657,24,8,1989,4,male,528.0,91,60,14,63,0,35,14,28
693,20589,1952952,27,7,1986,6,male,210.0,25,19,0,0,0,0,0,0
694,96996,1460116,20,18,1993,12,female,543.0,1084,847,5954,4536,4355,2336,1599,2200
695,66918,1710859,37,18,1976,5,female,657.0,153,78,76,89,76,62,0,27
696,4880,1210455,40,12,1973,9,female,287.0,2,2,125,42,125,42,0,0
697,65381,1173044,60,31,1953,8,male,98.0,148,107,1,11,1,2,0,9
698,36848,1040339,51,1,1962,7,female,99.0,53,22,3,7,3,7,0,0
699,89465,1224320,80,12,1933,5,male,1853.0,457,203,32,14,0,5,32,9
700,43721,1831723,57,23,1956,10,male,439.0,68,10,5,30,0,7,5,23
701,16872,1270561,18,16,1995,11,male,595.0,19,8,2,1,0,0,2,1
702,32924,1577248,44,25,1969,7,male,339.0,45,34,8,1,0,0,8,1
703,23133,1865703,14,1,1999,1,male,206.0,29,23,0,0,0,0,0,0
704,87432,1257737,16,9,1997,9,male,427.0,406,351,19,8,4,5,15,3
705,4210,2109178,35,5,1978,10,male,767.0,2,0,0,0,0,0,0,0
706,96961,1979634,46,6,1967,12,female,1968.0,1174,962,2404,2003,2315,1331,89,672
707,15649,1219571,23,25,1990,10,male,113.0,18,3,0,0,0,0,0,0
708,17404,1051447,20,12,1993,8,female,539.0,19,13,27,21,3,14,24,7
709,55037,1597219,18,9,1995,8,male,110.0,99,49,95,26,95,12,0,14
710,82151,1675735,20,3,1993,4,male,876.0,301,238,0,0,0,0,0,0
711,30568,1411782,29,1,1984,1,male,92.0,40,31,3,8,3,8,0,0
712,54089,1857450,26,3,1987,7,male,49.0,95,92,99,0,99,0,0,0
713,54066,1860820,36,7,1977,10,female,539.0,97,37,85,66,84,26,1,40
714,79377,1917496,18,18,1995,4,male,412.0,258,183,7,10,7,3,0,7
715,69881,1214618,19,1,1994,3,male,1814.0,171,89,93,58,93,29,0,29
716,72778,2014042,28,26,1985,6,male,410.0,191,111,69,5,69,4,0,1
717,7965,2148374,84,20,1929,7,male,1367.0,6,3,0,0,0,0,0,0
718,7223,1569782,66,30,1947,10,male,68.0,5,2,23,4,0,3,23,1
719,19898,2065960,44,23,1969,1,female,339.0,24,16,0,0,0,0,0,0
720,93350,1945854,14,3,1999,7,male,446.0,668,197,31,10,2,4,29,6
721,21856,1371792,26,1,1987,1,female,440.0,27,21,4,2,4,2,0,0
722,56268,1221878,55,14,1958,8,female,242.0,104,79,493,266,493,195,0,71
723,31640,1529428,52,17,1961,5,male,1592.0,42,29,2,29,1,11,1,18
724,15819,1717571,68,10,1945,2,female,1140.0,18,11,0,0,0,0,0,0
725,17878,1285013,74,8,1939,10,male,644.0,21,7,0,0,0,0,0,0
726,52105,1910702,23,20,1990,10,female,404.0,88,70,171,243,149,197,22,46
727,33368,1361829,27,25,1986,5,female,657.0,45,29,240,16,240,6,0,10
728,55906,1443107,48,26,1965,10,female,342.0,101,44,34,235,34,142,0,93
729,86494,1700971,15,27,1998,5,female,467.0,367,150,26,11,26,8,0,3
730,21950,1995249,20,26,1993,7,male,65.0,26,20,8,0,0,0,8,0
731,57132,1149684,43,13,1970,10,female,1446.0,107,61,889,958,606,186,283,772
732,70682,1922666,28,4,1985,7,male,523.0,177,105,31,4,31,4,0,0
733,5735,1123441,45,1,1968,1,female,48.0,3,2,116,4,116,0,0,4
734,38123,1557329,31,22,1982,4,female,558.0,54,19,57,19,57,8,0,11
735,38748,1014093,25,11,1988,5,female,576.0,56,17,8,18,8,12,0,6
736,5968,1913036,29,6,1984,6,male,155.0,4,1,0,0,0,0,0,0
737,74480,2039232,54,13,1959,10,male,1130.0,210,100,11,23,11,11,0,12
738,2157,1645428,21,30,1992,12,male,142.0,1,1,0,0,0,0,0,0
739,91339,1189903,18,20,1995,2,female,223.0,557,301,21,67,21,56,0,11
740,93652,1263044,108,28,1905,3,male,1448.0,655,319,201,368,100,280,101,88
741,30430,1025059,16,12,1997,12,male,238.0,40,33,1,21,1,17,0,4
742,2381,1822447,26,13,1987,12,female,271.0,1,1,0,1,0,0,0,1
743,21324,2053102,26,30,1987,6,male,89.0,27,25,0,2,0,2,0,0
744,42841,1527395,28,4,1985,4,male,324.0,65,32,6,33,0,23,6,10
745,78468,1683889,19,18,1994,9,male,699.0,250,191,10,16,10,16,0,0
746,85947,1649077,14,10,1999,7,female,281.0,342,187,396,20,327,17,69,3
747,30421,1650307,19,30,1994,3,female,401.0,41,14,1,1,1,0,0,1
748,21179,1530847,15,28,1998,3,male,312.0,27,21,0,0,0,0,0,0
749,22116,1017849,51,6,1962,10,female,754.0,27,14,16,20,16,16,0,4
750,96371,1559176,19,10,1994,2,male,612.0,1169,981,93,176,93,136,0,40
751,73526,1295578,16,25,1997,6,female,215.0,204,87,17,3,17,2,0,1
752,68780,1006129,100,6,1913,11,female,1591.0,164,92,41,99,40,57,1,42
753,55474,1800812,24,25,1989,5,male,50.0,104,69,1,2,1,2,0,0
754,39919,2037693,15,10,1998,4,female,293.0,58,6,57,33,57,28,0,5
755,2614,1980837,30,3,1983,3,male,928.0,1,1,0,0,0,0,0,0
756,77232,1880498,37,14,1976,4,male,690.0,234,161,0,1,0,1,0,0
757,9631,2065057,25,30,1988,7,male,369.0,10,2,0,0,0,0,0,0
758,89059,1935835,29,5,1984,3,female,238.0,437,257,1476,1813,1024,839,452,974
759,70428,2085563,100,17,1913,6,male,1838.0,178,16,4,10,4,4,0,6
760,51174,1894431,27,15,1986,10,female,568.0,85,57,196,67,171,54,25,13
761,18288,1314373,41,21,1972,2,female,448.0,21,19,54,6,54,4,0,2
762,68418,1764294,26,19,1987,8,male,82.0,166,163,3,0,0,0,3,0
763,28562,1079773,60,31,1953,1,female,594.0,37,3,0,0,0,0,0,0
764,45721,1352280,35,10,1978,10,female,506.0,73,31,15,3,0,0,15,3
765,38787,1972400,63,11,1950,7,male,69.0,57,50,12,2,12,2,0,0
766,68695,1298089,14,20,1999,7,female,23.0,166,42,23,48,23,35,0,13
767,77719,1713168,23,26,1990,7,male,350.0,234,185,56,43,56,15,0,28
768,89935,1370558,103,23,1910,1,male,1012.0,468,288,582,236,401,135,181,101
769,86957,2126080,18,17,1995,2,male,227.0,366,288,469,1,469,0,0,1
770,12130,1140127,14,27,1999,10,male,201.0,12,11,81,17,81,17,0,0
771,54100,1320891,18,6,1995,4,female,423.0,94,49,104,43,104,41,0,2
772,98996,1668695,24,25,1989,4,female,182.0,2938,1272,6018,17765,5843,11708,175,6057
773,22632,1471107,69,20,1944,10,male,1447.0,28,14,0,0,0,0,0,0
774,27778,2158325,35,16,1978,7,male,855.0,36,9,0,1,0,1,0,0
775,65586,1223323,64,25,1949,2,male,733.0,147,27,11,13,0,10,11,3
776,65845,1148541,43,23,1970,11,female,221.0,147,75,53,40,0,5,53,35
777,50515,1169888,44,10,1969,7,male,554.0,85,64,1,0,1,0,0,0
778,45857,1383248,70,22,1943,11,female,2325.0,73,55,32,25,0,15,32,10
779,56132,1702711,21,2,1992,5,female,591.0,104,82,154,303,56,168,98,135
780,41011,1795309,97,23,1916,7,female,1206.0,60,38,755,155,655,72,100,83
781,47275,1817116,25,14,1988,2,female,341.0,74,53,115,225,115,187,0,38
782,10211,1804969,48,1,1965,4,male,574.0,10,4,1,3,1,3,0,0
783,35217,1414622,25,9,1988,10,male,408.0,48,37,52,5,52,1,0,4
784,39012,1601422,31,24,1982,6,male,458.0,57,45,63,24,63,20,0,4
785,73995,1525267,33,13,1980,5,male,578.0,203,115,486,320,486,207,0,113
786,88039,1351549,16,24,1997,4,male,626.0,387,191,1066,2168,822,1392,244,776
787,83057,1666179,17,8,1996,7,female,296.0,296,95,844,12,844,6,0,6
788,19853,1164381,29,3,1984,4,male,271.0,24,14,0,1,0,1,0,0
789,84448,2058236,26,8,1987,4,male,323.0,326,128,15,0,15,0,0,0
790,16936,1128480,40,27,1973,9,male,559.0,19,15,2,5,2,4,0,1
791,70362,1841247,15,18,1998,8,male,705.0,178,121,2,38,2,36,0,2
792,67912,2040529,15,8,1998,5,male,247.0,160,146,107,26,30,11,77,15
793,63189,1962053,21,9,1992,3,female,336.0,133,108,716,49,454,20,262,29
794,10256,2129724,18,19,1995,1,female,230.0,9,5,2,0,2,0,0,0
795,60128,1412549,60,2,1953,6,female,715.0,120,86,229,22,229,22,0,0
796,14245,1554551,15,12,1998,11,male,661.0,17,14,0,2,0,2,0,0
797,29023,2087314,53,17,1960,9,female,959.0,38,27,11,5,8,2,3,3
798,16364,1027217,22,25,1991,11,male,6.0,19,16,0,0,0,0,0,0
799,29416,1602137,56,17,1957,11,,2011.0,38,16,296,198,210,76,86,122
800,32514,1131408,27,27,1986,6,male,161.0,45,22,0,11,0,2,0,9
801,92923,1575556,19,9,1994,12,male,105.0,589,401,733,1433,733,1312,0,121
802,64307,1590649,25,29,1988,10,male,681.0,140,101,0,0,0,0,0,0
803,22670,2024408,22,27,1991,7,male,215.0,28,19,1,0,1,0,0,0
804,95472,1503512,19,1,1994,9,male,122.0,938,167,143,1196,123,457,20,739
805,70155,2041002,25,20,1988,11,female,19.0,170,119,2741,407,2718,73,23,334
806,210,2135230,18,1,1995,1,male,532.0,0,0,0,0,0,0,0,0
807,14217,1589417,53,1,1960,1,male,110.0,15,8,110,41,110,32,0,9
808,13329,1043647,43,4,1970,7,female,122.0,14,9,24,2,24,2,0,0
809,47950,2143464,80,3,1933,2,female,1619.0,77,51,26,15,0,9,26,6
810,44125,1070849,108,6,1905,2,female,1431.0,68,33,150,49,150,40,0,9
811,24582,1309536,27,7,1986,1,male,261.0,31,20,0,2,0,0,0,2
812,15409,1343074,104,16,1909,9,female,1439.0,16,14,55,2,55,2,0,0
813,65307,1275514,15,12,1998,2,male,616.0,147,111,1,0,0,0,1,0
814,75014,2153632,19,13,1994,3,female,158.0,212,118,443,347,438,262,5,85
815,63824,1232374,16,6,1997,2,male,268.0,136,87,40,17,40,15,0,2
816,74360,2101959,16,4,1997,2,female,272.0,211,132,4,1,4,0,0,1
817,49947,1984464,35,12,1978,3,male,356.0,83,36,36,17,36,0,0,17
818,53460,1576816,21,5,1992,4,female,603.0,95,18,2,3,2,2,0,1
819,10669,1886624,27,21,1986,5,male,334.0,9,9,25,0,0,0,25,0
820,43405,1053175,17,25,1996,5,male,610.0,67,47,0,2,0,0,0,2
821,97898,2018305,20,31,1993,5,female,944.0,1514,662,2184,2482,2162,2125,22,357
822,27214,1264381,30,11,1983,1,male,1418.0,35,10,9,0,9,0,0,0
823,87508,1795987,15,4,1998,8,female,252.0,392,73,34,128,4,60,30,68
824,84457,2158128,20,8,1993,1,female,230.0,322,132,16,34,5,16,11,18
825,74490,1831002,15,3,1998,5,female,80.0,207,22,12,23,12,22,0,1
826,29694,1802524,26,31,1987,1,female,40.0,39,29,2,0,2,0,0,0
827,70010,1033085,61,15,1952,7,female,919.0,170,79,266,314,154,189,112,125
828,73868,1913112,32,8,1981,11,female,629.0,199,74,169,48,102,14,67,34
829,12986,2030589,27,10,1986,2,female,607.0,13,13,3,5,3,5,0,0
830,72065,1212861,46,11,1967,8,female,1265.0,186,147,487,206,486,116,1,90
831,25712,1085362,44,27,1969,9,male,121.0,32,26,3,0,3,0,0,0
832,28938,1042114,26,1,1987,8,male,482.0,37,17,7,2,7,2,0,0
833,14090,2138458,20,10,1993,4,female,617.0,15,10,14,0,14,0,0,0
834,64797,2098167,16,3,1997,3,female,318.0,143,14,45,11,45,11,0,0
835,89390,1116193,19,5,1994,10,female,323.0,457,396,17,10,11,7,6,3
836,25657,1114595,30,12,1983,8,male,233.0,32,15,2,1,2,0,0,1
837,90718,2144510,108,12,1905,10,male,1360.0,510,290,171,141,0,58,171,83
838,32693,1697235,30,26,1983,5,male,511.0,44,24,1,1,1,1,0,0
839,39693,1309779,19,7,1994,12,male,260.0,58,41,10,30,10,11,0,19
840,33682,1263454,34,9,1979,5,male,449.0,46,23,1,0,0,0,1,0
841,95568,1922831,15,15,1998,7,female,737.0,866,517,236,362,122,139,114,223
842,85749,1665082,16,4,1997,7,male,372.0,353,171,123,66,8,21,115,45
843,94244,1508085,23,4,1990,5,female,1052.0,758,186,11,104,11,84,0,20
844,29170,1178493,28,30,1985,6,male,117.0,38,33,29,0,13,0,16,0
845,9849,2105977,42,1,1971,6,male,635.0,9,5,0,0,0,0,0,0
846,57689,2183867,20,9,1993,6,male,662.0,111,31,17,14,17,14,0,0
847,65370,1608474,28,3,1985,9,male,658.0,150,124,1,7,1,4,0,3
848,88766,1935036,18,29,1995,4,female,127.0,434,316,167,238,150,170,17,68
849,72990,1805418,58,25,1955,5,female,456.0,191,110,322,110,322,90,0,20
850,47618,1072552,63,15,1950,8,female,799.0,78,41,0,0,0,0,0,0
851,30698,1872750,51,13,1962,3,male,483.0,41,27,8,5,0,2,8,3
852,31918,1852282,32,1,1981,1,male,229.0,43,35,10,61,10,43,0,18
853,26862,1943964,28,12,1985,8,male,174.0,34,26,1,0,1,0,0,0
854,35779,1859684,46,21,1967,11,male,34.0,51,49,2,0,2,0,0,0
855,18074,1281184,67,5,1946,10,female,1178.0,21,12,5,0,5,0,0,0
856,67882,2146934,16,15,1997,7,male,239.0,158,109,88,32,8,20,80,12
857,35184,1337412,101,29,1912,2,male,604.0,49,46,42,1,17,1,25,0
858,38668,1904243,14,12,1999,6,male,365.0,57,13,4,1,4,1,0,0
859,28951,2167147,28,9,1985,7,male,653.0,38,22,8,8,4,5,4,3
860,22924,1231719,14,12,1999,3,female,12.0,28,28,20,7,0,0,20,7
861,55793,1438572,26,26,1987,4,male,367.0,104,85,17,0,17,0,0,0
862,67367,1615646,112,1,1901,1,male,2100.0,158,65,0,2,0,2,0,0
863,9755,1662772,33,1,1980,1,male,347.0,9,5,0,0,0,0,0,0
864,76410,2165294,18,1,1995,2,female,202.0,222,106,5,38,1,12,4,26
865,56228,2053228,17,17,1996,2,male,433.0,102,99,322,4,14,3,308,1
866,77548,1458946,28,1,1985,1,female,520.0,238,43,20,56,20,44,0,12
867,4744,2130697,26,24,1987,9,male,559.0,2,1,10,0,9,0,1,0
868,19156,1091059,53,1,1960,1,male,491.0,22,15,6,0,0,0,6,0
869,21423,1593309,43,1,1970,1,male,542.0,26,26,0,0,0,0,0,0
870,81090,1782685,31,27,1982,8,male,1754.0,263,202,2881,1341,0,371,2881,970
871,74382,1351968,21,9,1992,11,male,620.0,207,147,5,1,4,1,1,0
872,60496,1222634,18,7,1995,8,female,251.0,124,65,2,5,2,5,0,0
873,93547,1619669,32,9,1981,6,male,571.0,680,408,108,208,96,102,12,106
874,44572,1150398,32,3,1981,11,female,211.0,70,55,5,4,5,4,0,0
875,61661,1869174,37,26,1976,8,male,353.0,129,67,20,80,0,31,20,49
876,6629,1346024,25,15,1988,1,male,31.0,5,1,0,1,0,0,0,1
877,34764,1014256,41,27,1972,8,male,241.0,49,31,1,2,1,2,0,0
878,53114,1307129,54,25,1959,6,female,1408.0,93,60,577,65,539,41,38,24
879,91288,1927198,17,14,1996,6,male,174.0,571,524,12,5,0,0,12,5
880,88871,1978576,15,22,1998,7,female,688.0,426,234,307,127,39,92,268,35
881,6646,1284544,26,22,1987,5,male,390.0,5,4,0,0,0,0,0,0
882,5564,1015334,39,18,1974,4,male,826.0,3,0,4,3,0,3,4,0
883,4677,2084645,31,11,1982,9,female,199.0,2,2,4,0,4,0,0,0
884,54960,1044844,33,5,1980,1,male,735.0,99,20,51,110,51,84,0,26
885,92560,1296665,17,15,1996,9,female,425.0,627,119,112,209,112,203,0,6
886,51746,1007597,76,30,1937,4,male,1514.0,89,36,13,5,12,4,1,1
887,9124,1168910,29,26,1984,3,male,594.0,8,5,2,0,2,0,0,0
888,61313,1942152,27,25,1986,2,male,922.0,126,52,1,0,0,0,1,0
889,7536,1294689,26,18,1987,3,male,457.0,6,6,0,1,0,1,0,0
890,35420,1113431,27,4,1986,10,female,51.0,49,32,426,136,426,121,0,15
891,34860,1965907,32,1,1981,10,male,444.0,49,26,4,0,0,0,4,0
892,16363,1135035,20,15,1993,10,female,535.0,20,10,0,0,0,0,0,0
893,95634,1129251,19,7,1994,10,female,454.0,894,550,317,606,13,250,304,356
894,30355,2085391,48,31,1965,3,male,520.0,40,27,1,1,0,0,1,1
895,37059,1798648,32,11,1981,5,male,81.0,52,33,18,0,18,0,0,0
896,39390,2099690,64,10,1949,5,male,2243.0,59,10,0,0,0,0,0,0
897,27645,1439893,35,6,1978,1,male,86.0,34,33,369,15,369,5,0,10
898,37078,1453080,23,1,1990,10,male,464.0,52,39,20,0,19,0,1,0
899,22719,1727735,18,23,1995,6,female,335.0,28,15,2,31,0,19,2,12
900,16372,1884197,21,14,1992,2,male,172.0,20,14,0,0,0,0,0,0
901,57609,1068905,30,21,1983,9,female,40.0,108,57,9,25,9,19,0,6
902,6609,1956501,23,3,1990,10,female,162.0,5,1,0,0,0,0,0,0
903,28620,2042126,78,28,1935,11,female,174.0,38,24,1,1,0,1,1,0
904,17415,1443076,108,23,1905,4,female,367.0,19,11,28,8,28,8,0,0
905,16396,2191015,23,2,1990,5,male,469.0,20,3,0,0,0,0,0,0
906,22607,1722343,54,8,1959,5,male,496.0,28,12,0,0,0,0,0,0
907,97062,1976011,31,10,1982,4,male,922.0,1605,295,1,1,1,1,0,0
908,88310,1209624,68,24,1945,2,female,1033.0,436,364,5,16,5,11,0,5
909,19639,1192288,42,18,1971,12,male,96.0,22,17,92,60,92,24,0,36
910,25937,1725768,15,12,1998,2,male,221.0,33,15,10,0,10,0,0,0
911,5026,1197896,23,23,1990,7,male,479.0,3,3,0,0,0,0,0,0
912,58876,1611510,73,20,1940,12,male,485.0,115,97,65,95,65,93,0,2
913,51232,1765004,52,22,1961,1,female,436.0,87,69,353,200,0,32,353,168
914,28840,1635602,16,11,1997,5,male,300.0,37,22,4,12,3,6,1,6
915,32907,1297999,63,16,1950,7,female,285.0,45,26,7,0,3,0,4,0
916,92022,2166732,59,25,1954,1,female,988.0,519,306,3068,3002,0,153,3068,2849
917,60681,1232081,94,1,1919,3,male,1010.0,124,73,14,7,0,3,14,4
918,35231,2084179,47,8,1966,3,male,365.0,49,21,60,2,60,1,0,1
919,21129,1926112,35,15,1978,7,male,413.0,25,22,190,184,189,167,1,17
920,28588,1001417,72,10,1941,6,male,372.0,38,26,0,0,0,0,0,0
921,33124,1528952,18,15,1995,6,male,43.0,45,37,28,5,28,1,0,4
922,30343,1042515,103,9,1910,8,male,1247.0,40,25,0,0,0,0,0,0
923,81877,1917114,30,21,1983,7,female,453.0,276,205,242,288,142,102,100,186
924,20652,1920750,47,25,1966,6,male,185.0,25,19,0,0,0,0,0,0
925,62790,1009008,45,30,1968,1,male,307.0,132,64,35,5,0,2,35,3
926,81089,2061073,45,15,1968,12,female,815.0,272,192,2010,1819,2010,1485,0,334
927,62033,2046090,55,2,1958,8,female,203.0,127,32,184,55,184,35,0,20
928,54896,1923241,21,3,1992,7,male,452.0,99,52,31,16,31,16,0,0
929,5465,1514345,46,13,1967,5,female,307.0,3,3,1,1,1,1,0,0
930,28629,1935697,35,25,1978,2,female,217.0,38,23,1,4,0,4,1,0
931,10166,2079885,63,18,1950,1,male,1181.0,10,8,1,0,1,0,0,0
932,38636,1000173,53,21,1960,5,male,119.0,57,55,3,0,3,0,0,0
933,43356,1201579,17,18,1996,7,female,32.0,66,42,647,39,130,12,517,27
934,60650,1968400,82,14,1931,4,male,1935.0,122,35,11,13,0,3,11,10
935,46576,1785586,58,19,1955,11,male,623.0,74,50,1,1,1,1,0,0
936,96796,2037218,103,19,1910,10,female,827.0,1260,711,888,949,888,770,0,179
937,49300,1068640,18,17,1995,2,male,454.0,82,13,0,0,0,0,0,0
938,1868,1038427,16,30,1997,10,male,0.0,0,0,4,4,4,4,0,0
939,32956,2057576,68,25,1945,11,female,1023.0,44,11,9,26,9,9,0,17
940,92340,1638746,108,5,1905,10,male,1429.0,593,192,25,22,1,8,24,14
941,49574,1072586,58,8,1955,1,male,1794.0,82,10,2,1,2,0,0,1
942,2118,1246581,20,5,1993,11,female,710.0,1,1,0,0,0,0,0,0
943,12670,1128289,15,16,1998,3,male,233.0,13,4,1,0,0,0,1,0
944,75383,1622379,103,4,1910,5,male,469.0,220,150,5,7,5,7,0,0
945,26976,1496111,39,28,1974,2,male,286.0,34,29,2,2,2,1,0,1
946,35916,1091199,41,21,1972,7,male,85.0,51,34,7,13,7,5,0,8
947,48376,1553327,45,25,1968,2,female,501.0,81,39,0,0,0,0,0,0
948,32308,2135160,54,20,1959,2,male,202.0,42,18,177,279,177,124,0,155
949,86268,2065735,63,1,1950,1,male,545.0,363,328,2,52,2,49,0,3
950,5542,1417561,39,1,1974,5,male,256.0,3,3,3,0,3,0,0,0
951,35111,1267974,24,21,1989,1,female,194.0,48,24,25,29,3,5,22,24
952,73733,1796664,52,8,1961,4,female,637.0,202,102,71,15,0,10,71,5
953,42540,1475802,25,1,1988,1,male,271.0,65,57,0,54,0,30,0,24
954,48968,1475386,55,14,1958,8,male,265.0,81,51,53,11,53,9,0,2
955,39850,1114667,61,22,1952,5,female,191.0,59,52,32,8,32,7,0,1
956,78028,1279471,23,19,1990,9,male,291.0,237,132,388,174,388,157,0,17
957,53110,1690055,59,25,1954,9,female,370.0,92,72,560,395,0,77,560,318
958,78995,2084125,59,24,1954,9,female,457.0,247,207,468,589,468,297,0,292
959,16518,1969160,35,15,1978,10,male,160.0,20,19,0,0,0,0,0,0
960,42141,1157337,37,20,1976,10,male,52.0,63,57,61,68,61,56,0,12
961,60242,2087382,28,25,1985,3,female,458.0,119,48,843,1098,838,939,5,159
962,62894,2012085,36,16,1977,1,female,171.0,130,89,67,56,67,17,0,39
963,56954,1806426,108,20,1905,5,male,110.0,105,92,89,1,89,1,0,0
964,81358,1607161,15,19,1998,8,male,710.0,276,182,7,0,7,0,0,0
965,54168,1036658,59,11,1954,6,female,1326.0,95,48,164,63,11,38,153,25
966,95554,1636509,19,19,1994,4,male,709.0,972,795,213,166,213,145,0,21
967,15045,1881610,23,1,1990,1,male,476.0,16,8,5,1,4,0,1,1
968,77943,1031041,28,13,1985,9,female,1222.0,233,127,219,365,179,144,40,221
969,92217,2107671,108,4,1905,9,male,1298.0,625,340,6,272,6,212,0,60
970,61440,1179526,20,23,1993,5,male,69.0,128,117,3,4,3,4,0,0
971,26419,1584414,71,3,1942,12,female,114.0,33,17,308,94,308,92,0,2
972,98447,1965680,19,15,1994,4,female,1653.0,3453,627,345,9071,88,7262,257,1809
973,41096,2085065,19,12,1994,5,female,629.0,62,11,0,13,0,6,0,7
974,28845,1578449,101,29,1912,4,male,548.0,37,28,4,0,4,0,0,0
975,55322,1074380,26,1,1987,1,male,81.0,101,89,0,4,0,1,0,3
976,7157,1013717,23,3,1990,12,male,990.0,5,1,9,0,3,0,6,0
977,19093,1959667,34,15,1979,8,female,212.0,23,9,4,0,4,0,0,0
978,40920,1394335,46,9,1967,11,male,650.0,61,12,180,40,180,34,0,6
979,12387,1981867,27,18,1986,2,female,438.0,14,9,0,1,0,1,0,0
980,43158,1390716,25,4,1988,10,male,365.0,65,40,57,34,57,15,0,19
981,7372,1463403,18,10,1995,8,male,268.0,7,7,0,9,0,5,0,4
982,85416,1468286,103,13,1910,10,male,743.0,338,151,13,35,13,28,0,7
983,67844,1880949,21,29,1992,10,male,611.0,160,69,68,80,68,45,0,35
984,62704,1778930,108,2,1905,11,female,876.0,131,38,19,9,19,8,0,1
985,43056,1729184,20,18,1993,6,female,386.0,65,50,28,50,20,20,8,30
986,12523,1336717,41,23,1972,6,male,126.0,14,10,0,0,0,0,0,0
987,87336,1926424,19,8,1994,9,male,756.0,395,279,7,2,0,2,7,0
988,73038,1861356,72,21,1941,11,male,950.0,195,97,488,171,2,38,486,133
989,96097,1312995,20,6,1993,10,female,158.0,1105,1048,2,5,2,4,0,1
990,14738,1465563,62,12,1951,7,female,1460.0,16,7,1,4,0,3,1,1
991,53411,1202780,25,1,1988,1,male,157.0,95,81,1,23,1,16,0,7
992,46192,1043771,43,8,1970,7,female,800.0,72,65,296,235,264,85,32,150
993,25327,1183189,32,3,1981,11,male,1316.0,32,3,0,0,0,0,0,0
994,10981,1765134,34,28,1979,1,male,654.0,11,9,0,0,0,0,0,0
995,44511,1825389,33,1,1980,1,female,710.0,69,43,3,1,3,0,0,1
996,54920,2071901,57,6,1956,1,male,384.0,98,70,37,27,37,11,0,16
997,8583,1649918,37,9,1976,7,male,545.0,7,5,38,10,0,6,38,4
998,68140,1277906,56,11,1957,7,female,1856.0,160,65,680,519,0,273,680,246
999,93082,1274441,18,21,1995,4,male,1482.0,661,315,0,15,0,11,0,4
1000,67745,1454543,22,21,1991,11,male,355.0,157,122,34,32,32,21,2,11
1001,89680,1556424,17,30,1996,3,female,290.0,465,259,130,29,1,9,129,20
1002,37323,1590412,37,8,1976,11,female,1065.0,53,16,160,10,0,0,160,10
1003,51750,1715065,55,24,1958,7,female,25.0,90,61,13,10,13,7,0,3
1004,25340,1551581,33,22,1980,10,male,466.0,33,24,0,0,0,0,0,0
1005,38655,1010658,52,28,1961,8,male,346.0,56,40,3,10,3,10,0,0
1006,91016,1381379,61,7,1952,9,male,813.0,488,390,1913,2264,28,1407,1885,857
1007,52184,1233052,58,26,1955,10,female,166.0,88,65,347,142,0,19,347,123
1008,98944,1090396,19,31,1994,12,female,247.0,2653,702,10386,5354,4451,2140,5935,3214
1009,21704,1471337,19,20,1994,1,female,172.0,26,15,2,2,0,2,2,0
1010,48348,1633339,30,28,1983,5,male,465.0,80,39,0,5,0,0,0,5
1011,86409,2068965,39,16,1974,9,male,1200.0,373,143,13,67,13,41,0,26
1012,56264,2013849,19,28,1994,1,female,44.0,104,94,488,219,431,115,57,104
1013,37120,1167816,31,11,1982,5,male,313.0,52,35,31,0,0,0,31,0
1014,15979,1067243,65,28,1948,8,male,1083.0,18,11,4,4,0,4,4,0
1015,61769,1608165,25,8,1988,12,male,433.0,127,36,39,0,26,0,13,0
1016,52129,2099161,73,28,1940,5,female,1506.0,90,64,207,69,0,13,207,56
1017,89540,1300576,48,25,1965,1,male,474.0,448,234,51,13,9,9,42,4
1018,260,1202760,20,22,1993,11,male,24.0,0,0,0,0,0,0,0,0
1019,42059,1721049,21,4,1992,3,female,149.0,62,49,43,15,43,8,0,7
1020,16325,2110453,18,24,1995,2,female,263.0,19,7,0,1,0,0,0,1
1021,47136,2014273,30,13,1983,7,female,222.0,74,26,49,12,49,12,0,0
1022,81864,1499569,23,24,1990,8,female,466.0,285,112,213,115,118,20,95,95
1023,96985,1130367,19,18,1994,10,male,517.0,1000,853,5367,3338,2780,2530,2587,808
1024,54011,1384325,19,12,1994,8,male,813.0,95,83,63,4,56,1,7,3
1025,17635,1174656,43,20,1970,9,male,478.0,20,7,243,15,243,12,0,3
1026,21718,1707750,22,6,1991,1,female,299.0,26,24,2,0,1,0,1,0
1027,82437,1307522,27,19,1986,3,male,1267.0,291,214,14,11,0,4,14,7
1028,73118,1394184,14,6,1999,4,female,583.0,200,111,0,1,0,0,0,1
1029,16409,1442341,24,3,1989,8,male,434.0,19,18,0,1,0,1,0,0
1030,47013,2011468,25,14,1988,5,male,227.0,74,68,24,0,19,0,5,0
1031,6993,1740596,51,7,1962,9,female,129.0,5,2,1,4,1,4,0,0
1032,12314,1480394,23,5,1990,9,female,79.0,14,9,0,1,0,0,0,1
1033,7100,2029256,24,1,1989,10,male,6.0,5,5,4,1,4,1,0,0
1034,49845,1526660,63,26,1950,8,male,844.0,83,38,18,30,7,12,11,18
1035,71694,1211318,108,19,1905,5,male,945.0,187,113,38,17,0,2,38,15
1036,80556,1930362,14,24,1999,4,female,265.0,262,136,24,61,6,41,18,20
1037,84837,1811870,80,10,1933,8,female,1581.0,328,160,220,85,220,67,0,18
1038,28887,1478511,60,9,1953,3,female,433.0,37,19,5,3,5,3,0,0
1039,13172,1351321,28,3,1985,3,male,435.0,13,6,10,16,1,7,9,9
1040,48293,1001230,22,13,1991,4,male,712.0,79,23,0,0,0,0,0,0
1041,52440,1200446,14,3,1999,10,male,116.0,91,87,1,1,1,1,0,0
1042,53425,2018761,35,19,1978,1,female,722.0,96,50,2,0,0,0,2,0
1043,24497,1216134,46,25,1967,3,female,515.0,29,13,3188,1319,3188,918,0,401
1044,87645,1815930,21,14,1992,11,female,243.0,400,103,78,193,78,164,0,29
1045,62796,1191274,14,19,1999,3,male,240.0,131,76,37,1,37,1,0,0
1046,62974,1508936,14,18,1999,2,female,81.0,134,64,105,13,105,11,0,2
1047,60493,1968874,21,2,1992,2,male,272.0,123,82,2,1,2,1,0,0
1048,65221,1488649,23,19,1990,7,male,1139.0,146,91,0,0,0,0,0,0
1049,12749,1695446,28,7,1985,8,male,387.0,13,4,1,0,1,0,0,0
1050,18744,2171616,69,26,1944,4,male,1478.0,23,12,0,2,0,1,0,1
1051,31873,1702113,30,11,1983,3,male,75.0,43,29,8,0,8,0,0,0
1052,77214,1754699,25,20,1988,1,female,279.0,234,181,0,0,0,0,0,0
1053,81451,2010119,18,28,1995,9,male,354.0,278,211,18,0,18,0,0,0
1054,67646,1714990,103,21,1910,8,male,1498.0,158,60,17,1,17,1,0,0
1055,90331,1013385,23,1,1990,1,male,246.0,499,345,14,147,14,90,0,57
1056,8400,1288063,28,1,1985,1,male,18.0,7,6,8,3,8,1,0,2
1057,43243,1396978,43,5,1970,7,female,422.0,65,38,109,63,109,38,0,25
1058,44521,1391257,18,20,1995,4,male,77.0,69,62,3,6,3,6,0,0
1059,24899,1745004,21,7,1992,7,male,374.0,31,29,11,4,11,3,0,1
1060,68758,1506027,18,3,1995,11,male,1251.0,164,93,35,53,35,43,0,10
1061,46486,1086392,55,29,1958,4,male,1112.0,75,28,0,0,0,0,0,0
1062,88976,1021146,13,22,2000,3,female,94.0,413,120,608,394,551,170,57,224
1063,88558,1820901,20,21,1993,12,female,138.0,416,67,50,33,50,25,0,8
1064,1744,1619439,25,1,1988,1,male,12.0,0,0,1,0,1,0,0,0
1065,20839,1788415,23,13,1990,9,male,95.0,25,22,4,2,0,1,4,1
1066,17064,1865217,33,9,1980,1,female,97.0,20,15,5,59,3,59,2,0
1067,83764,2091885,17,1,1996,12,female,246.0,307,223,136,253,130,154,6,99
1068,13960,1146663,25,1,1988,1,male,27.0,15,10,3,2,3,2,0,0
1069,28552,2006429,56,23,1957,5,female,298.0,37,26,0,0,0,0,0,0
1070,64843,1945619,26,29,1987,3,male,537.0,144,80,59,45,58,30,1,15
1071,47578,1894445,35,26,1978,8,male,217.0,77,69,0,1,0,0,0,1
1072,87673,1899128,21,1,1992,7,female,559.0,398,169,97,189,41,38,56,151
1073,30174,2080872,24,1,1989,1,male,500.0,41,34,0,1,0,1,0,0
1074,81899,1672841,21,4,1992,10,male,208.0,288,255,269,143,243,105,26,38
1075,39501,1367023,27,31,1986,10,male,187.0,58,38,2,17,1,14,1,3
1076,70897,1213324,17,2,1996,8,male,380.0,178,162,143,190,128,63,15,127
1077,97364,2045305,28,16,1985,3,female,538.0,1702,994,109,533,108,429,1,104
1078,10290,1179499,34,4,1979,1,male,127.0,9,9,2,1,2,1,0,0
1079,41617,2049941,18,2,1995,1,male,26.0,63,52,5,2,0,0,5,2
1080,68131,1443828,24,4,1989,4,male,285.0,158,82,649,215,640,192,9,23
1081,21813,1728067,67,10,1946,8,male,487.0,26,19,3,0,3,0,0,0
1082,9654,1041081,26,14,1987,6,female,497.0,10,4,0,0,0,0,0,0
1083,44023,1155773,26,29,1987,12,female,479.0,67,58,59,39,20,34,39,5
1084,60058,1674910,17,1,1996,5,female,136.0,117,85,146,145,145,90,1,55
1085,40404,1355336,18,1,1995,1,male,212.0,61,52,3,0,3,0,0,0
1086,49839,2127068,23,6,1990,5,male,272.0,83,36,18,0,0,0,18,0
1087,74342,1269509,32,7,1981,8,female,141.0,212,202,3,65,3,24,0,41
1088,61432,1410731,67,28,1946,11,male,1002.0,127,83,3,6,1,3,2,3
1089,46005,2057950,49,11,1964,7,female,474.0,72,53,70,28,0,5,70,23
1090,95223,1195583,22,1,1991,8,male,553.0,945,749,18,9,16,6,2,3
1091,82617,2118926,52,13,1961,3,male,1545.0,289,109,45,66,1,22,44,44
1092,13046,1154797,31,10,1982,4,male,1171.0,14,14,5,0,0,0,5,0
1093,93590,1871114,40,26,1973,2,female,1617.0,660,371,139,609,110,533,29,76
1094,18574,1257023,31,4,1982,4,male,7.0,22,18,0,0,0,0,0,0
1095,39300,1997248,26,22,1987,9,female,655.0,58,12,0,2,0,1,0,1
1096,8357,1378237,25,1,1988,1,female,12.0,6,5,6,4,6,4,0,0
1097,68341,2076055,61,29,1952,6,female,831.0,163,120,1,10,0,6,1,4
1098,7463,1584062,23,22,1990,1,male,18.0,6,3,0,0,0,0,0,0
1099,14671,1271110,65,13,1948,6,male,230.0,16,9,0,0,0,0,0,0
1100,34486,1304933,18,27,1995,11,male,188.0,48,37,0,1,0,0,0,1
1101,78448,1258523,52,28,1961,1,male,293.0,248,188,8,192,8,186,0,6
1102,20207,2008534,55,3,1958,11,female,1185.0,24,20,7,16,0,13,7,3
1103,93733,1932934,80,3,1933,4,male,1615.0,706,205,315,290,315,184,0,106
1104,9995,1682780,60,27,1953,6,female,288.0,9,7,0,0,0,0,0,0
1105,48829,1933347,20,25,1993,6,male,175.0,81,59,22,30,22,22,0,8
1106,91809,1754294,16,18,1997,11,female,395.0,570,183,398,244,396,104,2,140
1107,25430,1943754,59,3,1954,1,male,163.0,32,24,0,0,0,0,0,0
1108,4155,1016679,32,4,1981,7,female,397.0,2,1,0,0,0,0,0,0
1109,63628,2033330,53,4,1960,3,female,568.0,138,104,10,11,6,3,4,8
1110,88810,1624788,97,6,1916,2,male,1477.0,413,236,226,30,114,17,112,13
1111,52987,1789625,63,27,1950,10,female,1473.0,92,20,114,51,114,47,0,4
1112,36779,2012855,37,3,1976,1,male,1081.0,52,10,2,1,2,1,0,0
1113,40132,1571936,15,3,1998,3,male,236.0,61,30,0,18,0,10,0,8
1114,76464,1461725,19,26,1994,9,female,362.0,229,152,8,7,8,5,0,2
1115,63882,1168282,25,1,1988,1,male,351.0,135,50,54,65,54,63,0,2
1116,51999,2149769,26,12,1987,12,male,295.0,89,84,68,15,68,10,0,5
1117,91885,1979780,32,13,1981,11,male,560.0,527,433,653,569,503,130,150,439
1118,13208,1412072,54,9,1959,1,male,53.0,14,8,12,1,6,1,6,0
1119,19275,2037325,58,4,1955,2,female,1535.0,23,18,10,3,10,1,0,2
1120,18549,1318461,28,27,1985,10,male,21.0,23,13,0,13,0,5,0,8
1121,37219,1408168,50,20,1963,9,female,2046.0,53,20,59,87,59,70,0,17
1122,51740,1301291,26,11,1987,5,female,22.0,88,85,12,28,12,25,0,3
1123,17766,2113793,26,1,1987,1,male,55.0,21,12,0,1,0,0,0,1
1124,58867,1867103,19,4,1994,9,male,40.0,115,48,61,66,53,48,8,18
1125,46,1842851,14,22,1999,4,male,258.0,0,0,0,0,0,0,0,0
1126,32759,1325896,18,2,1995,4,male,131.0,44,31,2,5,2,4,0,1
1127,57117,2114791,17,26,1996,3,female,168.0,105,86,587,19,587,17,0,2
1128,794,1818534,28,25,1985,12,male,24.0,0,0,0,0,0,0,0,0
1129,2897,1841016,42,15,1971,10,male,21.0,1,0,0,0,0,0,0,0
1130,41496,1332237,16,1,1997,7,male,62.0,64,58,2,3,2,3,0,0
1131,43157,1919902,65,15,1948,3,male,216.0,65,46,57,5,57,4,0,1
1132,28063,1710282,50,16,1963,1,male,133.0,36,28,14,84,13,41,1,43
1133,83600,1232041,17,23,1996,6,male,176.0,315,179,46,42,17,20,29,22
1134,4725,1043045,16,8,1997,7,male,19.0,2,1,7,9,7,9,0,0
1135,51488,1219972,63,17,1950,7,female,575.0,89,81,2,0,0,0,2,0
1136,97529,1608257,18,11,1995,1,male,427.0,1761,1375,312,658,220,307,92,351
1137,9761,1498537,33,26,1980,3,female,309.0,9,6,0,0,0,0,0,0
1138,23218,2077684,23,11,1990,3,female,215.0,30,18,0,2,0,1,0,1
1139,80291,2103239,20,15,1993,1,male,165.0,271,246,3,3,3,3,0,0
1140,94811,1048824,18,11,1995,3,male,963.0,729,419,485,328,485,309,0,19
1141,38321,1233897,67,22,1946,5,female,995.0,54,28,935,124,935,61,0,63
1142,29017,1158633,27,30,1986,9,male,353.0,38,35,11,6,0,5,11,1
1143,6070,2020752,43,9,1970,3,male,698.0,4,0,0,0,0,0,0,0
1144,89230,1885695,16,29,1997,12,male,320.0,472,412,2,10,0,7,2,3
1145,24088,1587661,26,20,1987,5,male,1033.0,29,22,18,4,18,1,0,3
1146,42153,2074313,23,18,1990,11,male,368.0,63,33,66,61,29,38,37,23
1147,66253,1256330,15,15,1998,6,male,392.0,152,86,0,9,0,4,0,5
1148,58312,1295975,60,17,1953,2,male,384.0,115,107,0,0,0,0,0,0
1149,81222,1980760,18,14,1995,5,female,269.0,285,253,1,1,1,1,0,0
1150,8649,1992164,24,21,1989,10,male,344.0,7,1,154,206,154,140,0,66
1151,12013,2074432,17,4,1996,11,male,685.0,12,3,11,4,0,3,11,1
1152,69678,1758443,99,4,1914,12,male,1047.0,171,85,24,4,24,4,0,0
1153,10607,1867677,33,1,1980,1,male,30.0,10,10,15,65,15,16,0,49
1154,15920,1309841,25,30,1988,12,male,162.0,18,15,2,1,1,1,1,0
1155,87325,1210157,14,10,1999,1,male,584.0,402,290,6,19,6,16,0,3
1156,58438,1273119,14,10,1999,2,male,226.0,112,69,2,54,2,51,0,3
1157,46380,1851680,25,17,1988,11,female,348.0,76,48,0,0,0,0,0,0
1158,89496,1729912,102,9,1911,5,male,1083.0,452,265,39,17,0,5,39,12
1159,51134,2127762,28,19,1985,8,female,324.0,86,43,149,112,126,56,23,56
1160,4176,1223476,33,5,1980,5,female,535.0,2,1,0,0,0,0,0,0
1161,80483,1308087,15,23,1998,9,female,91.0,273,178,16,0,16,0,0,0
1162,26537,2117463,23,30,1990,9,male,387.0,35,22,0,0,0,0,0,0
1163,2841,1465962,39,6,1974,3,female,426.0,1,1,0,0,0,0,0,0
1164,170,1338620,17,14,1996,3,male,13.0,0,0,0,0,0,0,0,0
1165,3208,2092794,21,14,1992,11,male,27.0,1,1,1,0,1,0,0,0
1166,40055,1837054,65,7,1948,2,female,510.0,59,39,242,56,13,18,229,38
1167,76826,1215135,18,11,1995,11,male,389.0,223,144,98,46,96,37,2,9
1168,84895,1111991,17,31,1996,5,male,361.0,328,221,340,131,340,111,0,20
1169,34076,1650024,66,21,1947,7,female,1790.0,46,18,16,11,16,7,0,4
1170,52030,1830112,60,28,1953,10,female,414.0,88,53,88,15,0,2,88,13
1171,74682,1422445,108,10,1905,9,male,1615.0,209,65,47,60,18,32,29,28
1172,69529,1152806,21,23,1992,11,male,148.0,171,122,7,111,7,73,0,38
1173,30470,1839755,39,15,1974,4,female,369.0,40,22,2,6,0,0,2,6
1174,98208,2042959,17,5,1996,1,female,159.0,2003,173,49,946,34,863,15,83
1175,92807,1687270,18,30,1995,5,female,1137.0,580,317,402,37,376,9,26,28
1176,48118,2117456,75,14,1938,7,male,319.0,77,58,131,19,0,16,131,3
1177,16415,2164403,25,1,1988,1,male,232.0,20,9,0,3,0,3,0,0
1178,55230,2055832,52,23,1961,5,female,174.0,100,66,926,276,926,85,0,191
1179,3742,1524162,37,3,1976,9,female,26.0,1,0,94,26,0,0,94,26
1180,78697,2033513,51,29,1962,10,male,391.0,250,220,56,20,0,7,56,13
1181,32876,1382684,101,11,1912,7,male,154.0,44,36,5,5,5,4,0,1
1182,95440,1234798,18,1,1995,4,female,159.0,909,373,117,206,82,178,35,28
1183,40563,1711566,14,26,1999,9,male,89.0,60,35,11,2,11,2,0,0
1184,11810,1242199,62,18,1951,2,female,647.0,12,12,1,8,0,7,1,1
1185,56743,2097104,23,15,1990,8,female,622.0,105,34,17,0,17,0,0,0
1186,39992,1323852,66,28,1947,2,female,2149.0,59,36,125,89,113,70,12,19
1187,39344,1819552,37,5,1976,12,male,246.0,58,31,0,2,0,2,0,0
1188,92273,1330625,62,2,1951,1,male,1111.0,612,375,14,26,0,5,14,21
1189,93310,2016539,23,4,1990,12,female,332.0,654,150,20,84,18,70,2,14
1190,54206,1469182,58,11,1955,8,female,2438.0,95,36,205,154,119,108,86,46
1191,50406,1148079,29,5,1984,3,female,709.0,87,6,0,0,0,0,0,0
1192,64986,2083777,20,20,1993,8,female,388.0,140,66,214,82,27,13,187,69
1193,57281,1933915,54,6,1959,12,female,660.0,109,44,0,1,0,1,0,0
1194,93323,2092948,108,24,1905,8,female,912.0,668,88,22,8,22,8,0,0
1195,78839,1648900,53,25,1960,12,female,1299.0,244,116,150,285,24,74,126,211
1196,52396,1421488,101,4,1912,4,male,800.0,92,55,0,0,0,0,0,0
1197,39875,1499178,65,22,1948,8,female,1577.0,59,34,41,66,29,27,12,39
1198,60539,1529971,48,20,1965,4,female,226.0,124,90,3,5,3,4,0,1
1199,58146,1696839,36,10,1977,1,male,164.0,108,68,644,277,644,236,0,41
1200,76880,1865484,39,12,1974,10,male,916.0,228,195,139,6,139,5,0,1
1201,13136,2127989,22,18,1991,7,male,183.0,14,12,8,2,7,2,1,0
1202,50557,1958851,65,11,1948,9,male,895.0,85,36,2,2,0,1,2,1
1203,40266,1633562,62,8,1951,9,male,1179.0,61,44,0,0,0,0,0,0
1204,89542,1231369,100,2,1913,10,female,1599.0,467,328,50,92,0,16,50,76
1205,96569,1815748,103,27,1910,1,female,1420.0,1005,477,296,324,13,194,283,130
1206,58474,2069865,14,10,1999,2,male,456.0,114,61,3,29,3,13,0,16
1207,13287,1533452,66,14,1947,10,male,25.0,14,12,18,1,18,1,0,0
1208,90794,1897370,25,22,1988,5,female,246.0,497,244,273,761,273,496,0,265
1209,68522,1344997,32,15,1981,6,male,223.0,163,62,7,0,3,0,4,0
1210,67634,1724452,23,5,1990,5,male,178.0,161,139,15,24,15,24,0,0
1211,15034,1595619,15,11,1998,7,female,157.0,17,12,5,1,0,0,5,1
1212,7647,2007845,32,28,1981,5,male,536.0,7,1,0,0,0,0,0,0
1213,94507,1407918,17,2,1996,5,female,560.0,802,499,105,149,40,50,65,99
1214,7788,1735403,44,29,1969,10,male,768.0,7,7,0,0,0,0,0,0
1215,32498,1930575,26,18,1987,4,female,336.0,45,26,0,0,0,0,0,0
1216,37920,1884331,67,27,1946,3,male,1615.0,55,41,16,5,14,1,2,4
1217,56958,1110766,75,6,1938,3,female,1552.0,106,44,98,8,0,4,98,4
1218,79717,1171043,16,7,1997,7,male,195.0,260,194,77,53,77,52,0,1
1219,5161,1702491,31,25,1982,3,female,353.0,3,1,0,0,0,0,0,0
1220,25695,1615865,50,5,1963,3,female,646.0,32,19,3,9,0,4,3,5
1221,96571,1317069,18,25,1995,10,female,85.0,1023,272,295,127,293,55,2,72
1222,10274,1724000,41,18,1972,12,female,52.0,10,5,2,0,2,0,0,0
1223,50971,2124741,31,9,1982,9,female,227.0,86,39,44,65,44,57,0,8
1224,7242,1117499,90,2,1923,11,,1960.0,5,4,33,12,2,0,31,12
1225,9274,1820599,56,15,1957,2,female,523.0,8,3,14,1,14,0,0,1
1226,75330,1668092,33,8,1980,5,female,802.0,214,96,3,5,1,5,2,0
1227,71105,1315054,108,31,1905,8,male,181.0,182,113,1179,619,23,508,1156,111
1228,50347,1384042,21,24,1992,4,male,351.0,86,64,0,3,0,3,0,0
1229,21087,1343119,49,20,1964,9,male,527.0,25,11,83,4,83,3,0,1
1230,85214,2107871,19,15,1994,7,female,193.0,338,164,1,24,1,16,0,8
1231,25091,1191733,59,28,1954,6,female,304.0,31,18,101,15,101,13,0,2
1232,63553,1222080,23,18,1990,12,male,322.0,138,83,6,48,0,27,6,21
1233,73850,1489661,63,19,1950,11,male,674.0,201,126,155,159,0,97,155,62
1234,5136,2153385,29,7,1984,5,female,223.0,3,3,0,0,0,0,0,0
1235,37247,1362652,24,11,1989,1,male,1431.0,52,45,82,29,47,14,35,15
1236,9899,1112214,47,5,1966,4,female,286.0,10,5,0,2,0,0,0,2
1237,8414,1465702,13,10,2000,3,male,205.0,6,5,9,1,9,1,0,0
1238,47762,1115129,33,17,1980,2,male,1194.0,78,32,4,13,0,10,4,3
1239,40627,1768239,51,7,1962,2,male,549.0,60,21,17,62,0,45,17,17
1240,51352,1719403,23,21,1990,3,female,173.0,90,38,0,25,0,0,0,25
1241,52845,1457717,43,4,1970,7,male,677.0,93,46,40,240,18,52,22,188
1242,17961,1593118,23,11,1990,10,male,330.0,21,10,2,0,0,0,2,0
1243,91925,1634779,22,14,1991,1,female,1387.0,521,149,867,869,576,659,291,210
1244,93448,1069734,21,10,1992,4,female,382.0,721,479,60,71,42,27,18,44
1245,70934,1725430,42,18,1971,7,female,1681.0,176,122,175,175,146,128,29,47
1246,88392,1108056,91,10,1922,4,male,1583.0,429,246,14,18,5,17,9,1
1247,57868,1167356,31,5,1982,1,male,250.0,110,92,56,79,40,47,16,32
1248,90323,1979784,23,22,1990,11,male,706.0,478,317,13,10,13,8,0,2
1249,41015,1927854,33,7,1980,4,female,1210.0,60,28,889,948,0,627,889,321
1250,35746,1170784,44,5,1969,5,male,401.0,51,8,1,3,1,2,0,1
1251,83048,1911959,30,4,1983,6,female,379.0,301,227,740,306,740,104,0,202
1252,34262,1297893,39,23,1974,3,male,305.0,47,17,61,42,61,32,0,10
1253,278,1462261,19,3,1994,4,male,4.0,0,0,0,0,0,0,0,0
1254,19529,1329537,39,1,1974,1,female,1608.0,23,18,37,27,37,7,0,20
1255,38041,1735453,42,29,1971,9,male,341.0,55,38,33,13,33,12,0,1
1256,66766,1846132,16,13,1997,2,female,268.0,153,48,32,127,27,66,5,61
1257,58548,1939423,17,6,1996,4,male,330.0,115,68,7,1,7,0,0,1
1258,41820,1865787,56,29,1957,10,male,321.0,62,4,14,3,14,2,0,1
1259,20581,1092882,26,1,1987,1,male,197.0,25,20,0,0,0,0,0,0
1260,36496,1811798,19,6,1994,8,male,163.0,52,42,0,0,0,0,0,0
1261,86894,1865175,15,13,1998,2,female,257.0,369,163,324,105,324,103,0,2
1262,25901,1776197,46,5,1967,9,female,342.0,32,10,8,16,8,12,0,4
1263,89143,1088153,19,9,1994,7,male,434.0,465,396,0,0,0,0,0,0
1264,59746,2141533,23,4,1990,6,female,474.0,116,42,18,37,18,24,0,13
1265,51137,1845631,28,11,1985,9,female,162.0,87,52,145,101,145,56,0,45
1266,82715,1853784,48,16,1965,9,female,734.0,296,105,79,285,79,252,0,33
1267,15211,1841792,24,9,1989,9,female,284.0,16,7,13,0,0,0,13,0
1268,47312,2132147,70,5,1943,8,male,588.0,76,50,170,32,0,8,170,24
1269,87835,1540427,67,9,1946,6,male,180.0,386,314,254,77,233,19,21,58
1270,48207,1130046,54,2,1959,6,female,1674.0,78,44,580,142,580,96,0,46
1271,79610,1141068,36,22,1977,12,male,401.0,258,194,39,5,38,4,1,1
1272,71300,1623543,21,3,1992,5,male,174.0,190,126,1,140,1,103,0,37
1273,92075,1951446,20,21,1993,3,female,1242.0,580,38,0,7,0,7,0,0
1274,80512,2123927,40,22,1973,10,male,542.0,269,129,18,47,18,39,0,8
1275,81804,2077463,31,7,1982,5,male,399.0,287,220,145,44,145,33,0,11
1276,36397,1337537,51,30,1962,5,female,211.0,51,33,311,70,311,18,0,52
1277,77260,1128777,21,5,1992,9,male,509.0,237,224,1,0,0,0,1,0
1278,69189,1789977,17,21,1996,4,male,26.0,163,147,1011,397,839,342,172,55
1279,39310,1882941,29,6,1984,12,male,259.0,58,42,0,1,0,0,0,1
1280,86029,1770846,19,17,1994,1,female,706.0,347,277,808,144,563,27,245,117
1281,32856,1788693,18,12,1995,1,male,343.0,45,28,5,0,0,0,5,0
1282,64977,1293947,34,28,1979,6,male,1020.0,144,111,195,52,195,44,0,8
1283,55126,1331457,55,23,1958,9,female,1011.0,100,84,202,21,202,12,0,9
1284,63643,2159524,31,17,1982,8,male,306.0,135,93,11,12,0,4,11,8
1285,26541,1635239,25,10,1988,11,male,1379.0,34,18,0,0,0,0,0,0
1286,3668,1942752,18,5,1995,5,female,235.0,1,1,31,2,19,1,12,1
1287,44985,1508797,45,1,1968,1,male,534.0,70,36,206,14,0,1,206,13
1288,61458,1039760,19,8,1994,12,male,610.0,129,88,4,2,0,1,4,1
1289,70717,1683434,35,3,1978,9,female,893.0,180,121,37,2,34,1,3,1
1290,69233,1100510,15,14,1998,5,male,555.0,174,135,0,0,0,0,0,0
1291,91703,1530344,18,14,1995,5,male,225.0,573,511,228,64,0,28,228,36
1292,39359,2169632,42,18,1971,10,male,603.0,59,38,0,0,0,0,0,0
1293,36999,1850781,51,1,1962,1,female,1744.0,52,23,10,23,10,22,0,1
1294,80374,2025518,17,27,1996,12,male,382.0,274,207,7,2,7,2,0,0
1295,3720,1972868,23,17,1990,2,female,125.0,1,0,63,4,0,0,63,4
1296,44986,1534787,47,18,1966,8,female,250.0,69,40,209,389,151,126,58,263
1297,32184,1360273,21,12,1992,11,female,232.0,42,29,63,2,62,2,1,0
1298,90332,2128053,15,6,1998,11,female,474.0,485,336,15,41,0,7,15,34
1299,9372,1870440,48,14,1965,8,female,520.0,8,3,100,2,0,0,100,2
1300,39420,1418251,103,1,1910,4,,1956.0,59,29,1,1,0,0,1,1
1301,92243,1199771,18,20,1995,1,male,382.0,576,433,10,19,4,12,6,7
1302,57335,1553574,17,10,1996,1,male,558.0,109,90,1,0,1,0,0,0
1303,61056,1083557,70,9,1943,4,female,379.0,121,99,282,50,282,39,0,11
1304,70884,1779230,26,20,1987,3,female,274.0,180,162,126,88,120,78,6,10
1305,35633,1933516,51,11,1962,7,male,56.0,50,9,0,0,0,0,0,0
1306,53343,2072510,76,27,1937,10,female,1537.0,94,40,0,0,0,0,0,0
1307,47679,1977234,14,1,1999,1,male,222.0,77,59,1,2,1,1,0,1
1308,93552,1656621,20,12,1993,4,male,170.0,641,544,105,229,105,187,0,42
1309,69306,1218349,26,24,1987,7,female,1000.0,174,91,0,0,0,0,0,0
1310,47375,2120719,69,15,1944,2,male,725.0,76,49,304,271,0,52,304,219
1311,52672,2017762,53,27,1960,5,female,955.0,92,30,10,38,0,8,10,30
1312,98766,1314118,51,11,1962,4,female,391.0,3279,1115,1383,1926,1265,637,118,1289
1313,27677,1090429,62,18,1951,3,male,163.0,35,12,1031,69,1027,24,4,45
1314,69551,1841361,17,17,1996,9,male,905.0,173,50,9,0,9,0,0,0
1315,23607,1198100,15,4,1998,8,male,89.0,30,25,1,1,1,1,0,0
1316,86313,2148137,16,26,1997,6,male,267.0,367,182,5,88,5,65,0,23
1317,21546,1967824,72,23,1941,5,female,1222.0,26,18,0,0,0,0,0,0
1318,55667,1641335,16,5,1997,7,female,284.0,102,88,7,10,7,3,0,7
1319,23059,1581849,52,13,1961,9,male,504.0,28,13,82,22,82,17,0,5
1320,43124,1787861,54,1,1959,9,male,113.0,65,62,43,78,43,22,0,56
1321,81067,1345565,81,22,1932,8,female,1416.0,271,185,1186,467,0,187,1186,280
1322,42566,1711703,29,27,1984,2,male,450.0,65,37,0,0,0,0,0,0
1323,88739,1337524,18,12,1995,10,male,52.0,410,398,145,111,72,41,73,70
1324,2667,2025336,32,8,1981,1,male,346.0,1,0,0,0,0,0,0,0
1325,19866,1727958,33,16,1980,1,male,403.0,24,17,0,1,0,1,0,0
1326,18491,1054036,25,3,1988,12,male,224.0,22,20,0,0,0,0,0,0
1327,96478,1264796,20,1,1993,12,male,268.0,1155,392,183,247,183,190,0,57
1328,51608,1278288,22,21,1991,9,male,588.0,90,22,5,2,1,1,4,1
1329,38081,2139543,15,26,1998,11,female,27.0,54,15,43,7,43,2,0,5
1330,92845,1102266,15,9,1998,3,female,116.0,581,325,506,324,282,120,224,204
1331,54914,1820858,56,22,1957,11,male,1203.0,99,45,36,70,35,23,1,47
1332,84402,1546603,18,6,1995,6,male,308.0,321,160,10,0,10,0,0,0
1333,90058,1959579,16,9,1997,1,female,1169.0,454,150,2375,946,1844,347,531,599
1334,67398,1043069,33,29,1980,9,male,391.0,162,120,1,0,1,0,0,0
1335,41179,1289698,26,8,1987,2,male,274.0,64,57,0,0,0,0,0,0
1336,28338,1563075,18,7,1995,2,female,274.0,38,13,0,2,0,0,0,2
1337,73408,1882669,57,5,1956,6,male,260.0,204,135,6,13,6,10,0,3
1338,74063,1308817,48,23,1965,9,female,939.0,200,128,1747,178,1336,96,411,82
1339,3466,2036718,38,4,1975,9,female,58.0,1,0,4,1,4,1,0,0
1340,63569,1857062,26,21,1987,8,female,163.0,135,103,6,61,6,49,0,12
1341,6795,1175027,43,29,1970,9,female,388.0,5,4,0,1,0,1,0,0
1342,89960,1652008,19,15,1994,2,male,478.0,441,175,642,184,642,145,0,39
1343,66877,2069903,14,10,1999,7,female,292.0,156,114,65,19,65,17,0,2
1344,88642,2103442,17,26,1996,8,female,639.0,415,146,85,131,60,85,25,46
1345,13984,1165014,41,4,1972,12,male,308.0,15,10,4,0,4,0,0,0
1346,69946,2120703,52,14,1961,3,male,979.0,174,125,172,157,155,135,17,22
1347,23657,1513127,47,27,1966,1,male,557.0,29,23,1,10,1,5,0,5
1348,6237,1620195,41,29,1972,3,male,7.0,4,4,1,0,1,0,0,0
1349,27145,1047323,18,1,1995,4,male,106.0,35,10,7,0,1,0,6,0
1350,55430,1074275,25,18,1988,9,male,506.0,101,55,1,8,0,7,1,1
1351,42376,1493381,24,30,1989,4,female,397.0,63,27,333,121,333,104,0,17
1352,41395,1650219,39,1,1974,4,male,732.0,64,46,1,0,1,0,0,0
1353,45649,1813058,23,27,1990,1,male,581.0,71,31,10,12,4,6,6,6
1354,49913,1848796,28,25,1985,10,male,482.0,82,60,28,6,26,5,2,1
1355,33402,1643705,63,1,1950,1,male,990.0,45,11,459,264,0,40,459,224
1356,95750,2034163,19,7,1994,3,male,620.0,983,827,576,102,576,101,0,1
1357,22211,1231588,57,20,1956,3,female,163.0,27,16,30,19,13,3,17,16
1358,32883,1979240,108,9,1905,9,female,1197.0,45,27,6,0,0,0,6,0
1359,18530,1829060,27,26,1986,3,male,139.0,22,8,0,7,0,6,0,1
1360,69470,1391999,16,23,1997,5,female,15.0,170,126,4,13,4,2,0,11
1361,68439,1264221,37,30,1976,4,female,726.0,165,53,3,27,3,7,0,20
1362,28510,2122836,40,12,1973,6,male,423.0,37,35,0,0,0,0,0,0
1363,45945,2013699,108,18,1905,3,male,1023.0,73,38,47,0,47,0,0,0
1364,5929,1357166,26,1,1987,1,female,369.0,4,2,0,0,0,0,0,0
1365,77254,1724083,103,19,1910,5,male,1181.0,236,145,0,24,0,11,0,13
1366,58653,1485118,22,14,1991,4,female,59.0,115,54,15,48,15,46,0,2
1367,66340,1943878,31,13,1982,1,male,498.0,152,114,0,0,0,0,0,0
1368,62337,1834643,43,5,1970,12,male,1170.0,130,84,0,0,0,0,0,0
1369,79694,1509330,100,2,1913,4,male,1485.0,253,142,65,59,40,46,25,13
1370,75385,1350686,25,26,1988,4,male,878.0,221,156,5,31,5,13,0,18
1371,4364,1030713,49,15,1964,8,male,513.0,2,2,0,0,0,0,0,0
1372,26003,1996337,23,15,1990,7,female,510.0,32,11,14,15,0,3,14,12
1373,59955,1669669,56,3,1957,12,male,432.0,119,67,67,86,67,73,0,13
1374,86229,1752222,20,8,1993,11,male,950.0,365,190,1,6,1,2,0,4
1375,38676,1493413,64,24,1949,11,male,660.0,57,49,4,3,4,3,0,0
1376,12583,1610969,53,29,1960,2,male,1645.0,13,3,0,1,0,0,0,1
1377,82438,1455022,16,17,1997,7,female,546.0,294,137,14,1,14,0,0,1
1378,92414,2121804,18,14,1995,6,female,463.0,595,343,40,185,40,167,0,18
1379,50370,1105237,25,24,1988,12,male,192.0,87,51,0,0,0,0,0,0
1380,72638,1758163,27,15,1986,1,male,758.0,195,129,26,3,26,3,0,0
1381,39154,1821504,53,18,1960,3,female,273.0,57,51,257,25,257,24,0,1
1382,78846,1572621,33,1,1980,1,female,492.0,250,31,155,49,155,26,0,23
1383,23111,1585767,61,14,1952,5,female,1017.0,28,16,331,59,164,38,167,21
1384,98655,1918548,89,20,1924,7,female,1536.0,2025,946,854,676,845,476,9,200
1385,84443,2181245,50,22,1963,5,female,1576.0,324,112,14,21,14,14,0,7
1386,5717,1013786,20,25,1993,5,male,1077.0,3,2,55,6,0,1,55,5
1387,12151,1226662,34,25,1979,1,female,310.0,12,8,237,5,237,3,0,2
1388,49124,1351842,28,16,1985,6,female,33.0,79,48,162,143,162,132,0,11
1389,88745,1692321,15,23,1998,4,male,267.0,435,353,151,163,92,40,59,123
1390,19737,1028092,19,3,1994,4,female,295.0,23,14,455,324,450,93,5,231
1391,2305,1297965,23,19,1990,4,female,728.0,1,1,0,0,0,0,0,0
1392,94802,1827518,19,4,1994,5,female,617.0,735,359,514,1409,482,869,32,540
1393,84099,1958196,22,10,1991,11,male,263.0,309,265,1612,1097,1612,1028,0,69
1394,11288,1980838,51,17,1962,3,male,425.0,11,2,5,1,5,1,0,0
1395,38950,1966335,24,18,1989,10,female,361.0,56,37,42,31,41,15,1,16
1396,31633,1001724,54,3,1959,1,male,16.0,42,16,2,8,0,0,2,8
1397,72084,1979429,49,6,1964,7,female,1835.0,184,83,602,601,436,377,166,224
1398,82916,2025548,35,21,1978,10,female,805.0,303,238,281,355,281,316,0,39
1399,70324,1549482,16,10,1997,4,male,124.0,178,40,1,1,1,1,0,0
1400,97181,1681314,18,10,1995,9,male,194.0,1345,1163,18,59,18,35,0,24
1401,16776,1396066,74,3,1939,12,female,536.0,20,10,1,14,0,8,1,6
1402,31243,1468018,33,29,1980,6,female,215.0,40,4,1707,199,1707,93,0,106
1403,94769,1587953,14,18,1999,4,female,280.0,831,215,430,228,22,133,408,95
1404,78169,1853602,18,5,1995,5,female,249.0,248,127,0,2,0,1,0,1
1405,26052,2097535,24,25,1989,2,male,759.0,33,31,18,10,18,7,0,3
1406,30224,1523094,29,28,1984,9,male,276.0,41,30,0,0,0,0,0,0
1407,3076,1144041,59,21,1954,10,male,714.0,1,0,0,0,0,0,0,0
1408,28209,1109859,59,20,1954,7,female,216.0,36,29,90,41,0,28,90,13
1409,77598,1777335,103,30,1910,11,female,521.0,239,111,27,457,27,425,0,32
1410,62473,1438681,18,20,1995,1,male,242.0,134,67,3,2,3,1,0,1
1411,1842,1463219,27,20,1986,10,male,0.0,0,0,3,1,3,1,0,0
1412,35686,1250066,70,20,1943,2,male,1152.0,51,24,1,1,0,1,1,0
1413,15069,2193371,37,23,1976,3,female,376.0,16,5,6,3,0,0,6,3
1414,24569,1933912,25,1,1988,1,male,106.0,31,29,0,0,0,0,0,0
1415,80434,1898589,36,19,1977,2,female,476.0,268,164,10,643,10,569,0,74
1416,15231,1484681,23,8,1990,9,male,408.0,16,13,14,3,0,1,14,2
1417,15641,1373715,23,2,1990,1,female,784.0,18,9,0,2,0,1,0,1
1418,19691,1905311,27,25,1986,10,male,159.0,22,11,166,0,166,0,0,0
1419,8473,1989587,26,20,1987,5,female,290.0,7,5,14,3,4,3,10,0
1420,1229,1016996,37,26,1976,1,male,819.0,0,0,0,0,0,0,0,0
1421,78981,2032056,45,12,1968,3,female,1137.0,242,121,434,317,213,77,221,240
1422,73556,1753424,24,16,1989,10,male,741.0,202,117,22,0,6,0,16,0
1423,88605,1066118,30,12,1983,7,male,620.0,421,164,70,12,68,11,2,1
1424,42093,1842351,64,2,1949,5,female,693.0,62,37,51,68,0,24,51,44
1425,30522,2006579,108,1,1905,1,female,12.0,40,17,2,15,2,12,0,3
1426,7863,1583550,53,13,1960,10,male,517.0,6,5,0,0,0,0,0,0
1427,38343,1947610,15,21,1998,10,male,377.0,57,44,0,1,0,1,0,0
1428,5411,1239086,68,23,1945,6,male,951.0,3,3,1,0,0,0,1,0
1429,87690,1570712,26,21,1987,8,male,575.0,396,311,109,27,109,27,0,0
1430,73216,1639068,27,25,1986,2,male,60.0,200,165,0,3,0,3,0,0
1431,71580,1552237,28,29,1985,12,male,667.0,186,87,20,4,15,4,5,0
1432,76403,1963855,62,20,1951,12,male,416.0,229,91,5,1,0,0,5,1
1433,14022,2010734,32,29,1981,3,male,7.0,15,14,6,3,6,3,0,0
1434,56616,1788253,35,5,1978,7,male,470.0,106,24,4,52,4,24,0,28
1435,26357,1636676,62,17,1951,8,male,93.0,32,28,127,65,127,33,0,32
1436,17469,1316272,23,1,1990,1,male,147.0,19,17,40,42,32,32,8,10
1437,19980,1771518,61,11,1952,4,male,166.0,24,21,1,1,0,0,1,1
1438,76738,1704691,53,21,1960,8,male,566.0,226,193,57,88,57,55,0,33
1439,66248,1585654,14,13,1999,3,male,236.0,155,118,0,0,0,0,0,0
1440,25604,1144391,42,30,1971,10,male,856.0,33,9,1,2,1,0,0,2
1441,82427,1137639,103,5,1910,12,female,1218.0,299,56,11,117,11,101,0,16
1442,36648,2120853,64,27,1949,11,male,1673.0,53,28,0,3,0,0,0,3
1443,23084,2157339,36,18,1977,1,female,295.0,28,23,136,22,77,11,59,11
1444,80195,2025640,65,31,1948,7,male,1204.0,269,121,0,3,0,1,0,2
1445,38035,1465545,31,4,1982,11,male,303.0,54,14,30,28,30,19,0,9
1446,30014,1138931,31,25,1982,7,female,148.0,39,28,109,129,103,61,6,68
1447,95897,1828611,15,18,1998,11,female,237.0,914,510,1438,2274,891,1445,547,829
1448,66139,2082026,14,18,1999,10,female,365.0,146,90,349,268,22,106,327,162
1449,45694,1308507,27,28,1986,9,male,455.0,71,54,13,16,8,14,5,2
1450,6596,1584697,22,20,1991,8,male,154.0,5,4,0,0,0,0,0,0
1451,18351,1905939,50,3,1963,11,male,408.0,21,17,242,51,242,29,0,22
1452,75396,1506037,22,20,1991,10,female,344.0,220,68,6,1,6,1,0,0
1453,71775,1528313,19,1,1994,5,female,314.0,185,145,64,7,64,7,0,0
1454,81709,1661186,21,3,1992,3,male,462.0,281,215,88,34,87,18,1,16
1455,75320,1330687,53,28,1960,7,male,287.0,217,186,3,0,0,0,3,0
1456,90986,1510361,22,10,1991,4,female,82.0,478,369,1263,798,1195,485,68,313
1457,85954,1955480,34,7,1979,5,female,342.0,355,97,448,786,428,646,20,140
1458,65304,1327267,108,15,1905,4,male,1084.0,146,115,0,8,0,6,0,2
1459,79545,1414834,25,24,1988,1,female,202.0,257,181,27,54,11,38,16,16
1460,43967,1270855,58,2,1955,8,female,1318.0,67,25,40,23,17,1,23,22
1461,84419,1697205,18,6,1995,1,male,337.0,337,258,12,7,12,1,0,6
1462,15430,1933920,54,2,1959,12,female,764.0,16,7,67,208,44,135,23,73
1463,48355,1597830,34,7,1979,11,female,388.0,79,56,0,6,0,4,0,2
1464,70189,2012790,20,26,1993,12,male,415.0,178,146,0,0,0,0,0,0
1465,90476,1047262,20,7,1993,8,male,655.0,504,449,47,137,41,126,6,11
1466,5494,1860794,21,3,1992,1,male,176.0,3,2,2,0,2,0,0,0
1467,75883,1616727,30,28,1983,7,female,937.0,221,128,121,369,14,186,107,183
1468,60163,2064591,69,3,1944,8,male,1686.0,119,28,344,99,55,48,289,51
1469,56907,2113869,18,29,1995,10,male,355.0,106,61,61,16,0,3,61,13
1470,51926,1296628,74,22,1939,6,male,1753.0,89,86,43,64,4,42,39,22
1471,94322,1709102,18,24,1995,9,female,278.0,742,423,29,79,29,72,0,7
1472,16174,1122190,74,29,1939,3,female,2125.0,18,12,33,1,33,1,0,0
1473,58166,1058547,30,20,1983,4,female,362.0,108,46,1106,339,1106,329,0,10
1474,64094,1256604,55,30,1958,9,female,294.0,136,66,281,450,281,220,0,230
1475,79269,2016505,17,23,1996,8,male,215.0,260,240,2,11,2,8,0,3
1476,1272,1887225,38,14,1975,9,male,188.0,0,0,0,0,0,0,0,0
1477,75578,1190480,33,1,1980,1,male,266.0,216,47,21,45,21,12,0,33
1478,59477,2143417,26,27,1987,11,male,320.0,116,98,2,66,2,47,0,19
1479,66302,1199654,23,13,1990,6,male,570.0,153,106,0,0,0,0,0,0
1480,61414,1798504,50,22,1963,8,male,1343.0,127,78,2,45,2,23,0,22
1481,37826,1903145,64,26,1949,10,male,318.0,54,45,8,5,6,2,2,3
1482,93672,1154280,24,17,1989,3,female,596.0,656,502,224,197,187,86,37,111
1483,55998,1234131,60,13,1953,1,female,1314.0,102,40,64,19,17,3,47,16
1484,94210,1789989,21,5,1992,11,male,426.0,803,730,8,4,0,3,8,1
1485,41438,1927894,49,1,1964,4,male,738.0,62,58,1,2,1,2,0,0
1486,93001,1967803,25,21,1988,9,male,577.0,624,459,1438,1344,797,776,641,568
1487,93200,1350290,19,1,1994,1,female,376.0,691,302,4,250,4,100,0,150
1488,35463,2000099,16,29,1997,12,male,357.0,50,31,0,0,0,0,0,0
1489,18285,1451668,33,18,1980,10,female,442.0,21,16,53,22,53,22,0,0
1490,10061,1571168,30,24,1983,11,male,460.0,9,4,1,0,0,0,1,0
1491,59193,1658428,14,5,1999,5,female,146.0,117,93,0,7,0,2,0,5
1492,61237,1233470,26,13,1987,2,female,623.0,129,71,0,0,0,0,0,0
1493,35125,1188112,47,29,1966,10,male,347.0,49,28,26,62,26,34,0,28
1494,4140,1394252,33,4,1980,11,male,285.0,2,2,0,0,0,0,0,0
1495,77178,1350174,20,23,1993,9,male,637.0,231,183,0,0,0,0,0,0
1496,4652,2052158,27,24,1986,11,male,287.0,2,1,3,0,3,0,0,0
1497,56354,1283427,19,9,1994,4,male,200.0,106,93,0,0,0,0,0,0
1498,46938,1323025,27,12,1986,5,male,434.0,74,46,16,4,16,4,0,0
1499,34008,1564398,19,28,1994,2,female,26.0,46,18,10,6,10,5,0,1
1500,89312,2102098,20,19,1993,6,female,592.0,443,317,6,86,4,24,2,62
1501,28401,1491418,23,18,1990,9,male,341.0,37,18,0,0,0,0,0,0
1502,38436,1779132,29,18,1984,6,female,303.0,57,9,0,0,0,0,0,0
1503,21320,1198047,26,24,1987,4,male,265.0,26,19,0,0,0,0,0,0
1504,55802,1029091,24,26,1989,7,male,157.0,104,71,18,3,18,3,0,0
1505,82508,1984406,15,19,1998,1,female,1168.0,300,160,23,37,23,10,0,27
1506,61055,1072604,21,16,1992,7,female,286.0,124,96,292,194,250,119,42,75
1507,61198,1222197,21,8,1992,3,male,561.0,128,48,0,9,0,1,0,8
1508,79688,1594064,23,2,1990,4,female,484.0,251,182,61,70,43,63,18,7
1509,25339,1310075,33,17,1980,5,male,237.0,33,23,0,1,0,0,0,1
1510,89552,1418214,113,20,1900,6,male,1522.0,450,287,55,2,0,0,55,2
1511,95252,1348065,19,18,1994,11,male,456.0,883,682,26,74,17,52,9,22
1512,755,1192300,26,2,1987,3,male,103.0,0,0,0,0,0,0,0,0
1513,46727,1141183,35,3,1978,1,female,518.0,74,53,4,46,0,32,4,14
1514,92322,1400188,63,7,1950,11,male,1554.0,639,487,20,32,20,15,0,17
1515,69991,1655444,50,3,1963,7,female,1410.0,172,46,234,223,8,13,226,210
1516,28636,2112517,69,4,1944,4,male,1402.0,37,14,1,9,0,1,1,8
1517,72581,1154775,27,28,1986,2,male,470.0,197,197,17,2,12,1,5,1
1518,84831,2165165,54,25,1959,3,male,1046.0,321,143,207,118,207,75,0,43
1519,80253,1111983,108,2,1905,8,male,1777.0,266,199,2,41,0,30,2,11
1520,10822,1382322,19,28,1994,3,female,99.0,10,5,368,78,225,48,143,30
1521,51370,1575671,26,4,1987,3,male,624.0,88,57,0,0,0,0,0,0
1522,3735,1567443,38,19,1975,4,male,30.0,1,0,83,8,83,5,0,3
1523,7045,1782730,40,4,1973,6,female,131.0,5,3,2,1,2,1,0,0
1524,38438,1551085,31,10,1982,12,male,620.0,56,37,0,11,0,3,0,8
1525,36501,1314022,20,8,1993,5,male,154.0,52,49,0,0,0,0,0,0
1526,81155,1831669,25,14,1988,5,male,462.0,284,247,0,0,0,0,0,0
1527,54308,2124267,67,18,1946,4,female,1332.0,97,30,494,741,1,191,493,550
1528,65788,1669144,36,9,1977,1,female,264.0,146,135,38,32,32,9,6,23
1529,27339,1429170,84,18,1929,3,female,620.0,34,20,20,4,0,2,20,2
1530,75252,2031170,16,13,1997,7,female,551.0,221,115,1,0,1,0,0,0
1531,85882,2028129,23,11,1990,11,male,572.0,341,329,248,32,2,19,246,13
1532,76284,1139183,20,9,1993,4,female,418.0,222,198,1,0,1,0,0,0
1533,85242,1664013,23,1,1990,11,male,1158.0,350,274,2,21,1,18,1,3
1534,94763,1736988,103,11,1910,11,female,1175.0,834,399,416,540,392,263,24,277
1535,84608,1168279,17,18,1996,12,male,276.0,337,206,47,45,47,41,0,4
1536,83537,1821415,17,6,1996,6,male,419.0,312,151,31,18,31,15,0,3
1537,41621,1846211,16,18,1997,8,male,200.0,64,49,5,13,0,0,5,13
1538,94476,1817078,18,16,1995,11,female,64.0,745,42,88,151,86,51,2,100
1539,62561,1341909,18,18,1995,6,female,315.0,132,61,6,36,6,20,0,16
1540,88775,1371569,106,17,1907,9,male,479.0,436,303,178,235,178,203,0,32
1541,48215,2159648,14,3,1999,2,female,343.0,77,54,828,144,229,60,599,84
1542,52010,1786402,50,14,1963,6,male,912.0,88,40,80,35,80,29,0,6
1543,35004,1364156,58,21,1955,9,female,173.0,49,28,12,12,12,3,0,9
1544,15876,1805244,25,1,1988,1,male,634.0,18,10,1,0,1,0,0,0
1545,82020,1132553,22,14,1991,10,male,368.0,275,204,723,89,484,43,239,46
1546,43119,1781050,21,19,1992,8,male,73.0,65,60,44,30,20,17,24,13
1547,35343,1406322,46,21,1967,7,female,340.0,49,23,157,15,156,10,1,5
1548,96084,1877390,20,20,1993,8,male,322.0,1012,778,1,62,1,57,0,5
1549,81687,1798294,19,8,1994,10,female,387.0,276,156,77,198,77,147,0,51
1550,25304,1311578,28,13,1985,8,male,306.0,32,8,0,0,0,0,0,0
1551,63998,1863178,34,30,1979,10,female,232.0,138,102,142,42,4,28,138,14
1552,51749,1084377,29,5,1984,2,male,292.0,89,79,13,11,13,11,0,0
1553,11741,1204753,56,10,1957,6,female,212.0,12,8,0,0,0,0,0,0
1554,59628,1393687,25,21,1988,12,female,745.0,116,63,8,2,6,1,2,1
1555,83226,1163553,14,2,1999,5,female,247.0,312,269,1,0,1,0,0,0
1556,55405,1664243,72,3,1941,11,male,831.0,102,75,0,2,0,2,0,0
1557,59468,1528979,27,29,1986,8,male,401.0,120,82,2,2,2,2,0,0
1558,36034,1877160,24,3,1989,12,male,508.0,51,34,17,7,17,5,0,2
1559,46895,1176348,22,4,1991,3,male,448.0,74,47,12,25,2,9,10,16
1560,48074,1542633,31,21,1982,1,male,304.0,77,60,83,20,42,17,41,3
1561,60940,1137336,17,20,1996,3,male,480.0,122,101,105,24,76,23,29,1
1562,18830,1349394,76,25,1937,4,male,1744.0,23,8,1,2,0,2,1,0
1563,48089,2142706,42,5,1971,10,male,370.0,77,28,94,70,19,41,75,29
1564,7171,1121491,37,26,1976,7,female,268.0,5,4,10,0,10,0,0,0
1565,22232,1423344,21,1,1992,3,male,269.0,27,16,34,0,31,0,3,0
1566,38161,2015892,57,18,1956,1,male,300.0,55,39,73,2,73,2,0,0
1567,16975,1756317,41,9,1972,11,female,140.0,19,12,3,0,3,0,0,0
1568,1499,1233547,50,5,1963,6,female,174.0,0,0,0,0,0,0,0,0
1569,49234,1699044,19,27,1994,12,female,243.0,81,42,504,309,504,246,0,63
1570,52966,1417859,62,11,1951,5,female,981.0,91,69,101,1,3,1,98,0
1571,55414,1691948,13,5,2000,1,male,284.0,103,86,1,0,0,0,1,0
1572,58485,1249440,19,15,1994,11,female,554.0,115,62,4,13,0,1,4,12
1573,54986,1121256,49,12,1964,2,female,269.0,100,83,65,35,3,21,62,14
1574,57629,1634861,58,14,1955,8,female,738.0,111,22,11,3,0,2,11,1
1575,75375,1048883,25,10,1988,10,male,181.0,219,196,5,0,4,0,1,0
1576,93349,1055021,18,23,1995,2,female,636.0,699,392,31,1,0,0,31,1
1577,34451,1878402,21,14,1992,2,male,421.0,47,16,761,589,208,232,553,357
1578,50353,1998602,22,4,1991,1,male,355.0,86,67,0,3,0,0,0,3
1579,83330,1829735,20,29,1993,6,male,453.0,312,183,4,10,4,7,0,3
1580,19177,1475720,22,27,1991,10,male,688.0,22,13,6,8,6,6,0,2
1581,12504,1151828,38,22,1975,10,female,266.0,14,11,0,1,0,1,0,0
1582,82609,2150812,56,28,1957,9,female,1011.0,290,184,43,82,42,20,1,62
1583,60917,1738373,22,7,1991,8,female,383.0,124,56,87,80,87,75,0,5
1584,23864,1322601,79,5,1934,2,male,825.0,29,11,6,4,3,4,3,0
1585,18118,2117201,18,17,1995,1,male,307.0,21,13,9,0,9,0,0,0
1586,42349,1285084,54,3,1959,12,female,123.0,64,37,252,137,252,82,0,55
1587,60776,1388536,22,6,1991,11,male,124.0,123,114,29,29,29,28,0,1
1588,95163,1172261,14,5,1999,12,female,276.0,964,127,8,32,8,23,0,9
1589,38593,1431358,30,1,1983,1,male,198.0,57,38,2,0,2,0,0,0
1590,67081,1361841,23,8,1990,4,male,672.0,154,65,201,3,201,3,0,0
1591,81200,2184934,14,16,1999,4,male,263.0,285,172,1,5,0,2,1,3
1592,47015,1669869,62,10,1951,5,female,711.0,76,30,24,0,24,0,0,0
1593,47,1002019,14,30,1999,4,female,250.0,0,0,0,0,0,0,0,0
1594,62943,2001367,45,21,1968,6,female,714.0,131,85,85,76,85,45,0,31
1595,68121,1930574,62,28,1951,4,female,614.0,158,128,587,61,0,11,587,50
1596,93775,2137369,108,4,1905,10,female,3129.0,720,282,421,439,176,296,245,143
1597,98701,1869228,14,8,1999,2,female,191.0,2199,1410,1083,1579,856,858,227,721
1598,74846,2168231,17,9,1996,12,female,35.0,205,30,136,123,99,39,37,84
1599,48240,1700907,15,21,1998,2,male,283.0,80,27,0,0,0,0,0,0
1600,95428,1933431,15,22,1998,7,female,356.0,959,584,109,41,109,17,0,24
1601,43446,1274524,23,2,1990,3,male,507.0,68,43,0,0,0,0,0,0
1602,8163,1806705,44,28,1969,5,male,29.0,6,6,2,0,2,0,0,0
1603,87538,1737405,18,23,1995,1,male,521.0,386,266,42,62,31,47,11,15
1604,93185,2132963,15,1,1998,7,female,133.0,647,165,3,44,3,21,0,23
1605,22671,1141227,23,2,1990,2,male,37.0,28,19,1,0,1,0,0,0
1606,84511,1390740,15,7,1998,6,male,434.0,331,252,26,10,5,4,21,6
1607,85165,1041886,67,10,1946,9,female,1101.0,349,200,0,0,0,0,0,0
1608,94924,1456056,19,6,1994,9,female,873.0,808,510,1160,179,1153,110,7,69
1609,6150,1080355,63,30,1950,8,male,493.0,4,0,0,0,0,0,0,0
1610,85962,1245206,19,3,1994,4,male,352.0,342,127,480,774,111,386,369,388
1611,15298,1164961,19,24,1994,5,male,105.0,17,11,23,10,23,10,0,0
1612,5948,1226294,27,20,1986,6,male,152.0,4,3,0,1,0,1,0,0
1613,6507,1385045,14,9,1999,1,male,247.0,5,5,0,0,0,0,0,0
1614,10977,1327753,33,22,1980,8,male,39.0,11,11,0,0,0,0,0,0
1615,82628,1748760,15,8,1998,11,female,359.0,290,136,46,44,46,29,0,15
1616,71283,2029419,23,30,1990,7,female,463.0,185,129,1,0,1,0,0,0
1617,28763,1933963,23,14,1990,10,female,546.0,38,26,2,42,2,30,0,12
1618,68789,1907246,54,10,1959,8,male,539.0,167,109,44,43,44,32,0,11
1619,86787,2182790,18,8,1995,5,female,159.0,378,336,166,27,166,23,0,4
1620,1813,1922283,17,29,1996,12,male,77.0,0,0,2,1,2,1,0,0
1621,30109,2073223,19,7,1994,12,male,399.0,40,22,0,0,0,0,0,0
1622,47911,1312940,21,1,1992,1,female,70.0,78,60,17,71,17,68,0,3
1623,80095,1634677,14,24,1999,7,male,342.0,265,115,0,3,0,3,0,0
1624,85005,1743257,22,14,1991,2,male,394.0,334,244,783,773,783,712,0,61
1625,89961,1475598,23,19,1990,8,male,664.0,458,352,628,135,628,97,0,38
1626,4540,1508478,28,18,1985,2,male,102.0,2,2,1,0,1,0,0,0
1627,87599,2088801,18,15,1995,9,female,208.0,393,165,60,202,60,91,0,111
1628,82294,1262112,18,1,1995,11,male,381.0,289,227,3,0,3,0,0,0
1629,58507,2147608,108,2,1905,9,male,295.0,114,93,4,70,4,64,0,6
1630,5904,1305264,24,1,1989,3,male,139.0,4,0,0,0,0,0,0,0
1631,63280,1208079,21,12,1992,3,male,359.0,135,120,0,0,0,0,0,0
1632,24831,1100383,26,12,1987,6,female,421.0,31,19,5,3,5,2,0,1
1633,72165,1845666,49,24,1964,1,female,1628.0,185,153,1616,498,1449,139,167,359
1634,55794,1976280,55,24,1958,8,male,2346.0,101,32,17,2,17,2,0,0
1635,81311,2071959,28,18,1985,11,male,233.0,286,125,4,334,4,79,0,255
1636,93569,1501164,103,23,1910,11,male,975.0,713,466,123,147,89,123,34,24
1637,61455,2029333,68,5,1945,5,male,951.0,128,38,3,7,3,5,0,2
1638,12522,1070209,41,1,1972,1,male,329.0,13,12,0,0,0,0,0,0
1639,87497,1817823,18,15,1995,6,male,323.0,401,271,32,4,0,1,32,3
1640,41648,1579191,40,17,1973,11,male,433.0,64,17,5,15,5,13,0,2
1641,32858,1749537,49,26,1964,3,female,426.0,44,6,5,2,0,1,5,1
1642,60934,1212368,42,18,1971,3,male,178.0,121,104,97,33,89,25,8,8
1643,48745,1862905,16,27,1997,1,male,268.0,81,48,13,4,10,2,3,2
1644,38943,1625449,36,3,1977,5,male,491.0,56,35,40,119,39,114,1,5
1645,35377,1554238,51,3,1962,7,female,511.0,49,28,216,14,0,3,216,11
1646,63954,1934043,23,26,1990,12,female,544.0,138,91,90,110,77,68,13,42
1647,1747,1233564,26,1,1987,2,male,646.0,0,0,1,0,1,0,0,0
1648,9505,1817508,19,29,1994,9,male,14.0,9,4,0,0,0,0,0,0
1649,69964,1613711,71,4,1942,12,female,348.0,171,49,196,170,0,19,196,151
1650,69156,2019352,14,13,1999,3,male,25.0,166,152,615,49,602,41,13,8
1651,83717,1629356,25,22,1988,4,female,483.0,317,176,99,110,99,94,0,16
1652,22092,1090654,21,4,1992,2,female,437.0,27,21,15,9,3,4,12,5
1653,66159,1913103,18,2,1995,3,male,101.0,150,137,433,64,433,63,0,1
1654,86853,2020504,16,7,1997,10,male,432.0,363,127,242,185,231,119,11,66
1655,92361,1382372,20,10,1993,10,female,179.0,637,275,28,130,28,125,0,5
1656,91515,1870034,42,15,1971,4,male,1029.0,527,341,72,157,72,108,0,49
1657,17004,1989950,17,31,1996,10,male,27.0,20,14,3,7,3,5,0,2
1658,19438,2188023,62,17,1951,3,male,682.0,22,13,23,13,0,3,23,10
1659,79011,1542113,51,25,1962,7,female,1930.0,245,164,585,1121,148,715,437,406
1660,38307,1514263,57,20,1956,10,female,687.0,54,26,533,152,524,96,9,56
1661,52373,2065180,46,21,1967,6,female,349.0,91,52,0,0,0,0,0,0
1662,63894,1215674,34,18,1979,1,female,252.0,135,118,59,32,47,19,12,13
1663,6216,2079926,18,25,1995,11,male,10.0,4,3,1,0,1,0,0,0
1664,89740,1122890,19,11,1994,2,male,265.0,455,311,180,81,159,64,21,17
1665,84492,1429625,13,29,2000,3,female,82.0,334,265,22,160,22,62,0,98
1666,62397,1133153,18,5,1995,6,male,275.0,131,124,1,15,1,14,0,1
1667,32841,1610963,23,1,1990,1,female,190.0,45,38,4,4,4,4,0,0
1668,30824,1643082,57,13,1956,7,female,39.0,40,30,16,0,16,0,0,0
1669,41887,2017852,82,31,1931,5,female,244.0,64,41,19,8,19,6,0,2
1670,36481,1398230,18,1,1995,1,male,67.0,53,44,0,0,0,0,0,0
1671,78967,1771230,22,12,1991,8,female,2148.0,245,104,393,511,33,331,360,180
1672,44325,1054468,28,1,1985,1,male,130.0,69,63,0,0,0,0,0,0
1673,32639,1967003,74,18,1939,11,female,360.0,45,33,0,3,0,2,0,1
1674,39661,1306815,76,20,1937,4,female,25.0,59,37,9,16,0,4,9,12
1675,4122,1762604,31,31,1982,1,male,412.0,2,0,0,0,0,0,0,0
1676,54123,1602595,21,6,1992,11,female,227.0,97,89,119,6,10,0,109,6
1677,86975,2133187,38,15,1975,11,male,481.0,359,220,516,560,516,471,0,89
1678,19112,1246367,17,11,1996,8,female,285.0,23,11,5,0,0,0,5,0
1679,88995,1719589,108,11,1905,6,male,1779.0,426,299,787,912,86,492,701,420
1680,52793,1463237,22,7,1991,11,female,884.0,91,49,29,22,1,4,28,18
1681,1791,1340376,102,1,1911,1,male,29.0,0,0,2,0,0,0,2,0
1682,30839,1479895,14,23,1999,4,male,133.0,40,26,18,0,18,0,0,0
1683,43442,2075973,22,17,1991,10,male,445.0,67,36,0,0,0,0,0,0
1684,16033,2057370,19,9,1994,9,male,42.0,18,18,7,0,4,0,3,0
1685,26056,1232584,77,22,1936,2,female,1769.0,33,16,18,5,18,0,0,5
1686,60326,1715870,23,2,1990,12,male,363.0,123,109,0,0,0,0,0,0
1687,25798,1706925,38,19,1975,4,male,404.0,32,11,5,0,5,0,0,0
1688,74934,1663919,57,19,1956,8,female,1600.0,205,172,227,150,227,123,0,27
1689,20970,1945308,55,25,1958,4,male,562.0,25,9,18,6,0,4,18,2
1690,90835,2002208,33,2,1980,2,,2016.0,493,291,357,886,85,601,272,285
1691,10534,1279082,52,25,1961,4,male,184.0,10,9,10,10,1,8,9,2
1692,12560,1912953,50,16,1963,5,male,420.0,14,4,0,0,0,0,0,0
1693,36744,1630405,69,12,1944,6,male,1110.0,52,35,1,4,1,3,0,1
1694,12213,1198903,18,17,1995,1,male,602.0,14,11,0,0,0,0,0,0
1695,16025,1731244,16,5,1997,11,female,14.0,18,10,6,9,6,6,0,3
1696,53622,1103895,38,24,1975,9,female,988.0,95,16,8,1,0,0,8,1
1697,61381,2185293,34,15,1979,1,female,213.0,127,45,2,5,0,2,2,3
1698,69477,1480972,23,7,1990,4,male,230.0,174,123,5,2,0,2,5,0
1699,96502,1048671,16,16,1997,4,male,648.0,1173,823,220,153,52,99,168,54
1700,8220,1820425,48,1,1965,1,male,173.0,6,6,3,3,2,2,1,1
1701,2993,1160211,48,30,1965,10,male,152.0,1,1,0,0,0,0,0,0
1702,59404,1513659,33,3,1980,2,male,434.0,120,25,1,0,1,0,0,0
1703,22927,1156959,47,5,1966,4,male,788.0,28,11,20,3,20,1,0,2
1704,27500,1998437,39,28,1974,9,female,942.0,34,20,58,22,58,16,0,6
1705,2676,1809789,32,12,1981,3,male,241.0,1,0,0,0,0,0,0,0
1706,10920,1279970,25,1,1988,1,male,168.0,11,9,0,0,0,0,0,0
1707,83888,1595530,47,1,1966,4,female,1825.0,310,212,271,572,252,522,19,50
1708,45982,1521143,36,10,1977,7,male,1124.0,73,43,62,23,0,9,62,14
1709,32281,2039340,29,24,1984,4,female,391.0,43,14,131,76,131,70,0,6
1710,59677,1805620,24,15,1989,1,male,299.0,116,85,11,16,10,1,1,15
1711,44025,1347309,73,24,1940,2,female,1597.0,67,41,59,6,59,5,0,1
1712,71627,1942516,38,23,1975,12,female,963.0,183,102,27,54,23,27,4,27
1713,68037,1477295,108,22,1905,11,male,1516.0,159,117,284,41,1,22,283,19
1714,85552,1135320,20,27,1993,4,male,434.0,340,217,35,29,35,27,0,2
1715,72734,1514453,49,16,1964,10,male,440.0,197,176,55,46,18,27,37,19
1716,51495,1807143,21,6,1992,5,male,936.0,90,8,2,86,0,19,2,67
1717,60857,1553527,20,7,1993,8,male,273.0,121,83,55,11,55,10,0,1
1718,42302,1338274,58,17,1955,11,female,322.0,64,45,163,86,163,34,0,52
1719,4152,2063455,32,16,1981,5,female,318.0,2,2,0,0,0,0,0,0
1720,79220,2039601,20,16,1993,12,male,587.0,252,140,1,0,1,0,0,0
1721,8296,1893517,56,29,1957,12,female,865.0,6,2,4,2,4,1,0,1
1722,35776,1579173,31,28,1982,8,female,395.0,51,35,2,0,2,0,0,0
1723,2312,1772890,23,11,1990,4,female,174.0,1,0,0,3,0,3,0,0
1724,72902,1651358,34,2,1979,12,female,1928.0,191,138,153,286,78,102,75,184
1725,16002,2160933,19,16,1994,12,male,108.0,18,15,5,0,5,0,0,0
1726,20626,1564558,36,22,1977,2,male,55.0,25,22,0,0,0,0,0,0
1727,75401,1438034,18,13,1995,6,male,438.0,218,106,6,5,6,4,0,1
1728,79985,1291447,18,28,1995,5,male,302.0,251,209,492,75,492,74,0,1
1729,79747,1912350,18,29,1995,7,female,463.0,252,103,88,290,14,91,74,199
1730,47460,2082102,66,11,1947,1,female,1492.0,76,42,1142,121,78,25,1064,96
1731,76634,1183719,31,27,1982,1,female,380.0,229,146,29,30,29,20,0,10
1732,53370,1673695,51,8,1962,12,female,929.0,94,56,1,10,0,6,1,4
1733,76773,1854043,20,13,1993,4,male,231.0,224,177,69,99,45,71,24,28
1734,90060,1436417,52,19,1961,2,female,734.0,459,273,2096,866,1781,656,315,210
1735,20264,1306993,46,9,1967,8,male,135.0,24,18,10,27,10,13,0,14
1736,33151,1983124,61,12,1952,3,female,1434.0,45,15,34,16,32,13,2,3
1737,58564,1634058,69,15,1944,4,male,1375.0,114,46,8,10,7,4,1,6
1738,10224,1379845,25,1,1988,1,male,18.0,10,10,2,0,0,0,2,0
1739,94866,2101049,30,26,1983,9,female,659.0,779,408,801,1467,98,539,703,928
1740,54811,2116636,69,7,1944,1,female,656.0,100,36,18,6,0,4,18,2
1741,12217,1164396,18,1,1995,1,male,226.0,13,11,0,0,0,0,0,0
1742,41052,1900658,16,27,1997,5,male,599.0,64,18,0,0,0,0,0,0
1743,89290,1689593,19,1,1994,5,female,440.0,450,293,4,5,4,5,0,0
1744,58543,1717207,19,1,1994,1,male,260.0,112,88,7,5,0,1,7,4
1745,91011,1166799,14,9,1999,8,female,525.0,486,315,1528,1178,1150,368,378,810
1746,41620,1138795,47,16,1966,7,male,129.0,64,39,5,4,0,2,5,2
1747,15529,1766379,38,22,1975,1,female,320.0,17,12,194,101,193,67,1,34
1748,85486,1893295,16,2,1997,5,male,658.0,358,260,24,2,24,2,0,0
1749,65146,2056762,15,24,1998,4,male,505.0,145,96,0,0,0,0,0,0
1750,82418,2187134,22,18,1991,6,male,394.0,300,205,11,2,11,1,0,1
1751,72512,1995138,21,3,1992,2,male,1136.0,197,131,9,0,9,0,0,0
1752,77986,1367768,24,1,1989,6,female,133.0,240,94,306,933,210,404,96,529
1753,63703,1538123,34,25,1979,7,female,200.0,135,95,16,14,16,12,0,2
1754,50442,1366747,45,31,1968,8,male,258.0,86,8,0,0,0,0,0,0
1755,50467,1014231,63,3,1950,7,female,46.0,86,60,0,10,0,8,0,2
1756,77775,1401690,15,8,1998,1,male,514.0,239,118,83,15,83,15,0,0
1757,12576,2041353,52,23,1961,6,male,323.0,14,9,0,0,0,0,0,0
1758,96982,2103193,15,3,1998,5,male,1042.0,1266,905,5022,6168,3053,3000,1969,3168
1759,97989,1996736,18,7,1995,2,female,459.0,1643,570,4334,7737,3709,4781,625,2956
1760,63021,1711821,28,21,1985,9,female,315.0,134,121,155,92,97,82,58,10
1761,44949,1551166,56,23,1957,2,female,998.0,70,38,129,65,129,31,0,34
1762,42800,1416903,51,22,1962,6,male,357.0,65,42,4,3,4,3,0,0
1763,84289,1143267,18,30,1995,9,female,501.0,322,281,2,65,2,31,0,34
1764,65811,1232267,19,6,1994,8,female,373.0,147,86,44,36,44,19,0,17
1765,49270,1168049,42,8,1971,2,male,603.0,79,42,1293,154,1293,118,0,36
1766,82942,1933767,68,27,1945,3,female,1717.0,294,202,387,627,1,209,386,418
1767,39135,1622808,56,10,1957,9,female,1350.0,57,16,204,389,0,153,204,236
1768,13832,1465860,21,18,1992,2,male,233.0,15,12,1,0,1,0,0,0
1769,92214,1593714,36,3,1977,6,male,1333.0,597,209,6,6,6,4,0,2
1770,79294,1795678,19,9,1994,12,female,53.0,261,28,3,123,3,27,0,96
1771,92500,1073710,20,3,1993,2,male,764.0,631,390,79,305,79,224,0,81
1772,31818,1401515,21,1,1992,1,male,245.0,43,36,6,1,2,1,4,0
1773,4183,1494682,33,9,1980,9,male,460.0,2,2,0,0,0,0,0,0
1774,26708,1466990,52,28,1961,12,male,464.0,35,27,0,0,0,0,0,0
1775,62077,1231857,54,9,1959,6,female,172.0,128,103,245,8,245,3,0,5
1776,408,1680549,22,1,1991,1,male,602.0,0,0,0,0,0,0,0,0
1777,29524,1350961,25,12,1988,12,male,265.0,39,36,0,4,0,3,0,1
1778,84879,1686249,57,2,1956,1,female,945.0,325,252,304,152,0,68,304,84
1779,64707,1739733,26,8,1987,7,female,419.0,144,35,22,0,22,0,0,0
1780,59235,1195317,20,17,1993,12,male,512.0,116,85,0,5,0,0,0,5
1781,32706,1618042,25,2,1988,4,male,40.0,44,41,1,3,1,3,0,0
1782,50392,1272218,26,26,1987,8,male,148.0,86,71,0,0,0,0,0,0
1783,59199,2071477,15,28,1998,7,male,242.0,118,117,0,25,0,23,0,2
1784,4036,1755802,26,1,1987,1,male,75.0,2,1,0,2,0,2,0,0
1785,52043,1988546,29,6,1984,4,female,538.0,89,48,97,56,94,55,3,1
1786,46359,2183177,21,8,1992,6,male,512.0,75,75,0,3,0,3,0,0
1787,54746,1810758,34,29,1979,3,male,339.0,100,57,11,155,10,98,1,57
1788,49606,1464485,32,23,1981,1,male,900.0,83,47,3,10,2,3,1,7
1789,52106,2098908,69,19,1944,3,female,323.0,88,29,172,22,172,16,0,6
1790,15149,1153629,38,16,1975,1,female,443.0,16,11,9,0,9,0,0,0
1791,1944,2088808,27,7,1986,1,female,332.0,0,0,51,51,0,0,51,51
1792,78114,1637209,26,20,1987,12,female,461.0,237,173,938,1269,938,1058,0,211
1793,83857,1863754,31,1,1982,10,female,319.0,304,258,225,72,225,38,0,34
1794,39325,1441264,29,16,1984,8,female,622.0,58,21,0,1,0,1,0,0
1795,31838,1339719,68,15,1945,2,male,243.0,42,29,7,5,2,0,5,5
1796,65702,1069420,19,17,1994,11,female,415.0,147,65,23,6,23,6,0,0
1797,30407,1226526,51,19,1962,9,male,490.0,40,37,1,0,1,0,0,0
1798,4225,1150001,37,1,1976,2,male,209.0,2,2,0,0,0,0,0,0
1799,72227,1435168,20,2,1993,8,male,791.0,195,85,0,2,0,1,0,1
1800,29131,1343075,31,4,1982,8,male,192.0,38,13,23,23,23,14,0,9
1801,44434,1779022,18,18,1995,11,male,471.0,69,58,1,3,1,3,0,0
1802,83149,1102233,18,24,1995,7,male,206.0,306,275,0,0,0,0,0,0
1803,61050,1582824,36,16,1977,11,female,583.0,123,111,255,143,255,114,0,29
1804,72333,1191455,16,23,1997,1,male,215.0,191,139,1,1,1,1,0,0
1805,57169,2153987,17,19,1996,2,male,174.0,111,100,0,1,0,0,0,1
1806,8671,1009333,32,25,1981,3,female,187.0,7,7,345,84,345,70,0,14
1807,84817,1414203,55,21,1958,12,,2298.0,332,207,193,751,26,452,167,299
1808,29936,1749893,64,15,1949,12,female,1086.0,39,18,42,32,39,16,3,16
1809,55398,1488023,56,30,1957,8,male,301.0,103,101,0,1,0,1,0,0
1810,77759,1397463,26,10,1987,6,male,254.0,234,182,76,185,76,124,0,61
1811,35973,1751925,18,12,1995,8,female,884.0,50,5,11,0,2,0,9,0
1812,44970,2087492,22,19,1991,11,male,1007.0,70,41,180,2,180,0,0,2
1813,75440,2047799,19,9,1994,3,female,428.0,214,160,8,29,8,10,0,19
1814,16754,1736305,51,19,1962,4,male,552.0,20,12,1,1,0,0,1,1
1815,96057,1917938,28,13,1985,11,male,1796.0,1252,566,0,3,0,1,0,2
1816,51512,1342736,23,4,1990,12,male,425.0,88,70,2,1,2,0,0,1
1817,77020,1136291,21,9,1992,10,male,168.0,224,196,399,45,399,37,0,8
1818,33205,1560060,23,21,1990,9,male,19.0,44,39,49,0,49,0,0,0
1819,14842,1293596,30,18,1983,8,male,544.0,16,9,2,1,0,0,2,1
1820,70539,1968051,20,17,1993,5,male,272.0,179,114,11,9,11,9,0,0
1821,53588,2057456,26,5,1987,7,male,94.0,94,80,6,8,6,6,0,2
1822,64268,2066563,21,13,1992,7,male,466.0,144,81,0,0,0,0,0,0
1823,69801,1011092,108,27,1905,9,female,848.0,174,70,58,4,0,4,58,0
1824,55501,2055121,20,9,1993,4,male,161.0,104,76,2,6,1,1,1,5
1825,74554,1479865,108,23,1905,9,male,1156.0,209,76,20,1,15,0,5,1
1826,31833,1085504,56,25,1957,11,male,617.0,42,22,7,0,0,0,7,0
1827,63519,1659736,18,27,1995,3,male,354.0,138,62,4,0,4,0,0,0
1828,16882,1040925,74,11,1939,9,female,156.0,19,12,2,2,0,1,2,1
1829,2266,1588536,22,18,1991,9,female,286.0,1,0,0,0,0,0,0,0
1830,74024,1234280,30,15,1983,3,female,494.0,204,111,670,820,197,459,473,361
1831,36195,1051889,37,2,1976,3,male,226.0,51,35,46,22,46,10,0,12
1832,88795,1740310,28,16,1985,3,male,272.0,420,368,194,566,194,460,0,106
1833,44701,1410639,26,1,1987,1,male,371.0,70,55,14,13,14,6,0,7
1834,46814,1145748,33,1,1980,12,male,46.0,75,73,6,18,6,10,0,8
1835,81252,2006082,24,13,1989,6,male,332.0,280,224,2,1,1,0,1,1
1836,97223,1369459,15,1,1998,3,female,614.0,1309,316,29,114,9,54,20,60
1837,94622,1568586,46,9,1967,7,female,1169.0,812,318,191,428,181,201,10,227
1838,52131,1982061,59,9,1954,7,male,1941.0,88,12,211,137,207,73,4,64
1839,47106,1470565,19,28,1994,11,male,397.0,74,33,40,18,40,11,0,7
1840,16213,2158489,65,27,1948,4,female,97.0,18,11,55,9,55,5,0,4
1841,32473,1977026,23,23,1990,8,female,96.0,44,27,0,28,0,27,0,1
1842,87586,2050170,26,15,1987,9,male,422.0,388,231,54,85,54,58,0,27
1843,1635,1768581,63,28,1950,1,male,191.0,0,0,0,0,0,0,0,0
1844,64936,1602642,37,31,1976,10,female,575.0,141,71,139,197,139,108,0,89
1845,69278,1766795,20,2,1993,9,male,645.0,170,111,0,0,0,0,0,0
1846,55891,1634953,19,14,1994,12,male,465.0,104,77,32,8,32,7,0,1
1847,55087,1063038,23,14,1990,7,female,35.0,100,71,137,97,137,80,0,17
1848,12137,1783525,48,2,1965,5,female,247.0,12,10,116,39,0,19,116,20
1849,2397,1327349,25,1,1988,1,male,181.0,1,1,0,0,0,0,0,0
1850,2966,2156229,47,7,1966,3,male,27.0,1,1,0,0,0,0,0,0
1851,19484,1003843,39,3,1974,4,male,297.0,22,9,28,11,28,9,0,2
1852,96834,1549109,26,28,1987,3,male,299.0,1113,375,1197,2024,635,1023,562,1001
1853,54930,1762192,73,25,1940,1,male,1167.0,100,32,42,4,11,4,31,0
1854,57736,1521730,18,21,1995,5,female,471.0,111,61,24,21,24,19,0,2
1855,60516,1783033,51,11,1962,3,male,1184.0,122,33,3,10,2,4,1,6
1856,57677,1509393,44,30,1969,11,male,426.0,108,46,16,1,16,1,0,0
1857,38301,1860119,25,1,1988,1,male,179.0,54,43,451,28,451,26,0,2
1858,68689,1504834,18,19,1995,4,male,524.0,166,91,22,7,22,7,0,0
1859,21267,1318023,23,1,1990,3,male,287.0,26,16,0,2,0,2,0,0
1860,64910,1835347,35,15,1978,3,male,275.0,143,109,110,61,110,56,0,5
1861,7402,1697683,20,7,1993,1,male,160.0,7,5,0,0,0,0,0,0
1862,75026,1719191,37,3,1976,11,male,619.0,207,78,462,124,462,74,0,50
1863,69084,1043720,17,19,1996,12,female,455.0,163,75,330,104,298,64,32,40
1864,7792,1299115,45,3,1968,1,male,461.0,7,7,0,0,0,0,0,0
1865,68579,1986580,18,17,1995,5,female,194.0,165,85,10,25,10,8,0,17
1866,96753,1543460,16,19,1997,2,female,562.0,1207,665,791,695,589,661,202,34
1867,22285,1906713,39,14,1974,10,male,377.0,27,13,51,0,26,0,25,0
1868,1752,1621971,33,20,1980,10,male,144.0,0,0,1,0,1,0,0,0
1869,4497,1841852,62,15,1951,6,female,1826.0,2,0,1,0,0,0,1,0
1870,19865,1529861,33,11,1980,12,male,92.0,24,11,0,0,0,0,0,0
1871,36992,1072714,17,2,1996,3,male,122.0,52,41,10,1,10,1,0,0
1872,52914,1373486,31,4,1982,12,male,425.0,93,56,66,12,66,7,0,5
1873,24284,1723886,45,1,1968,1,male,148.0,30,22,52,33,52,28,0,5
1874,50688,1909676,18,1,1995,9,male,283.0,86,78,6,0,6,0,0,0
1875,84986,1291355,24,13,1989,7,male,511.0,326,277,651,225,651,204,0,21
1876,88947,1315487,24,10,1989,4,female,254.0,436,19,468,1246,468,1185,0,61
1877,31961,1137627,20,13,1993,8,male,606.0,42,27,14,2,0,0,14,2
1878,39600,1811286,90,9,1923,11,female,918.0,58,31,5,35,5,13,0,22
1879,11067,1855540,58,25,1955,5,male,243.0,11,3,0,0,0,0,0,0
1880,41489,1999238,59,29,1954,11,female,659.0,63,36,2,1,2,1,0,0
1881,29052,1253666,21,28,1992,8,female,171.0,38,16,14,9,3,6,11,3
1882,13074,1239771,34,3,1979,1,male,551.0,13,6,5,1,5,1,0,0
1883,14573,1304366,44,2,1969,2,male,412.0,17,12,0,0,0,0,0,0
1884,97116,1258839,69,16,1944,10,male,1109.0,1521,1235,6,74,6,56,0,18
1885,89293,2037499,18,31,1995,1,male,648.0,465,351,4,17,4,14,0,3
1886,56595,1776390,57,20,1956,4,male,1924.0,106,35,4,2,0,0,4,2
1887,15853,1815200,52,19,1961,2,male,640.0,18,10,1,2,0,1,1,1
1888,46320,1273353,19,13,1994,11,male,284.0,75,44,0,2,0,1,0,1
1889,56087,1668772,20,8,1993,5,female,241.0,102,52,117,84,83,31,34,53
1890,65988,1604142,32,7,1981,5,male,1386.0,146,64,128,163,127,93,1,70
1891,69181,2182544,56,1,1957,12,female,1342.0,167,59,986,123,986,42,0,81
1892,31866,1691017,65,27,1948,5,female,869.0,43,20,8,2,0,0,8,2
1893,70664,1923792,24,11,1989,8,male,108.0,177,125,27,17,0,1,27,16
1894,75684,1172915,19,28,1994,7,male,221.0,218,138,41,16,0,9,41,7
1895,70967,1351707,19,6,1994,11,male,244.0,181,77,215,29,18,8,197,21
1896,68318,1308933,80,27,1933,3,male,291.0,167,20,0,10,0,0,0,10
1897,18236,1580199,52,5,1961,7,male,536.0,21,14,27,6,0,2,27,4
1898,70977,1063794,18,21,1995,4,female,136.0,182,93,223,460,171,234,52,226
1899,50256,1404853,46,22,1967,12,male,321.0,84,37,710,49,0,10,710,39
1900,90947,1929744,27,15,1986,7,male,232.0,478,424,770,80,770,76,0,4
1901,58064,2108967,50,15,1963,2,male,675.0,111,89,226,19,225,15,1,4
1902,64955,2169902,34,14,1979,11,female,204.0,143,125,169,185,112,96,57,89
1903,54884,2157369,108,27,1905,2,female,2112.0,98,54,29,28,1,17,28,11
1904,94733,1946973,83,30,1930,4,female,1559.0,746,210,361,450,0,155,361,295
1905,68822,1183884,15,24,1998,8,male,407.0,164,108,55,49,40,25,15,24
1906,84882,1411859,45,11,1968,1,female,2076.0,335,78,301,143,301,90,0,53
1907,63330,2107528,31,11,1982,12,male,579.0,135,97,0,0,0,0,0,0
1908,48166,1149642,18,8,1995,2,male,517.0,77,59,240,4,16,2,224,2
1909,82411,1476954,20,21,1993,3,female,97.0,291,125,10,89,10,88,0,1
1910,87966,1639924,14,8,1999,6,female,290.0,391,85,617,144,422,82,195,62
1911,76641,1276582,25,10,1988,1,male,336.0,227,131,32,24,0,9,32,15
1912,57752,1757173,32,8,1981,5,male,437.0,110,40,27,19,27,19,0,0
1913,80239,1655339,28,11,1985,1,male,347.0,274,242,1,16,1,14,0,2
1914,38788,1207804,47,6,1966,7,female,494.0,57,10,12,14,12,10,0,4
1915,48900,1991280,31,6,1982,2,male,193.0,80,50,33,85,33,49,0,36
1916,27912,2032261,102,7,1911,10,male,381.0,36,30,2,0,2,0,0,0
1917,21201,1459167,17,3,1996,5,male,197.0,27,17,0,0,0,0,0,0
1918,54466,1431874,41,4,1972,4,female,517.0,100,59,0,3,0,1,0,2
1919,14023,1349612,33,25,1980,10,male,62.0,15,12,6,1,6,0,0,1
1920,37135,1007600,82,17,1931,4,female,560.0,53,32,34,1,33,0,1,1
1921,38858,1474360,22,11,1991,1,female,435.0,57,26,20,27,20,26,0,1
1922,32018,1036729,54,19,1959,9,female,1084.0,43,29,20,8,1,0,19,8
1923,81458,1271587,20,26,1993,3,male,219.0,283,254,19,97,3,32,16,65
1924,11554,1930265,18,25,1995,10,male,238.0,12,9,0,0,0,0,0,0
1925,38002,1633447,60,4,1953,1,female,428.0,55,39,25,3,25,2,0,1
1926,8504,1237067,24,1,1989,7,female,341.0,6,5,17,4,17,4,0,0
1927,24685,1494771,24,14,1989,10,male,76.0,31,31,1,1,0,1,1,0
1928,25769,2124565,20,12,1993,10,male,556.0,32,16,4,5,4,5,0,0
1929,89913,1381131,25,14,1988,8,male,1295.0,447,316,494,1,372,1,122,0
1930,31396,1407424,29,2,1984,8,female,583.0,43,25,0,0,0,0,0,0
1931,91012,2111668,15,16,1998,4,female,512.0,501,323,1851,1935,1684,1050,167,885
1932,51753,1324989,30,29,1983,9,male,1094.0,90,67,14,0,0,0,14,0
1933,46241,1901968,39,6,1974,9,female,450.0,71,33,564,246,564,156,0,90
1934,84428,1749050,73,13,1940,8,female,1582.0,326,89,13,39,1,26,12,13
1935,524,2083195,23,9,1990,9,male,344.0,0,0,0,0,0,0,0,0
1936,22631,1202923,69,4,1944,4,male,744.0,28,15,0,0,0,0,0,0
1937,36817,2095377,33,30,1980,5,female,573.0,52,21,3,15,1,13,2,2
1938,35624,1549695,46,5,1967,9,female,916.0,51,14,0,0,0,0,0,0
1939,24981,1403336,34,14,1979,1,female,655.0,31,18,25,4,25,4,0,0
1940,75154,1397333,19,9,1994,9,male,656.0,220,204,0,0,0,0,0,0
1941,17211,2030490,21,19,1992,11,female,477.0,20,14,9,4,9,1,0,3
1942,34026,1750827,20,22,1993,10,female,53.0,47,36,11,54,10,25,1,29
1943,31038,1584501,50,15,1963,12,male,732.0,40,23,57,10,50,9,7,1
1944,5536,1065753,20,11,1993,11,male,244.0,3,1,3,0,3,0,0,0
1945,31152,2163900,39,8,1974,12,female,152.0,40,34,154,9,154,6,0,3
1946,54220,1765632,26,18,1987,8,male,333.0,97,86,216,271,216,248,0,23
1947,27951,1928537,54,23,1959,2,male,423.0,36,7,4,42,2,32,2,10
1948,24351,1216774,54,10,1959,6,female,197.0,29,4,81,24,0,2,81,22
1949,35876,1046943,16,19,1997,2,female,71.0,50,26,5,46,5,41,0,5
1950,66235,2084943,33,1,1980,11,female,262.0,145,56,1993,681,1993,243,0,438
1951,67247,1887906,16,5,1997,6,male,491.0,161,139,0,0,0,0,0,0
1952,76153,1855318,71,2,1942,11,female,703.0,215,112,2880,74,0,33,2880,41
1953,13405,1215196,76,27,1937,10,female,227.0,14,12,40,4,0,0,40,4
1954,23487,2001007,67,16,1946,3,male,191.0,30,9,0,0,0,0,0,0
1955,46753,1034703,63,7,1950,4,female,211.0,76,53,4,5,4,5,0,0
1956,40814,1206879,39,27,1974,11,female,715.0,61,30,75,147,60,53,15,94
1957,7355,1966579,17,7,1996,8,male,10.0,6,6,0,0,0,0,0,0
1958,87894,1701711,20,28,1993,2,female,425.0,393,74,354,77,324,52,30,25
1959,22648,1297678,24,9,1989,1,male,231.0,28,13,1,0,0,0,1,0
1960,59807,1983051,15,26,1998,6,female,236.0,119,81,27,9,27,9,0,0
1961,24921,1616081,16,19,1997,4,male,197.0,31,24,14,19,14,3,0,16
1962,25821,2088392,58,24,1955,3,female,114.0,32,20,6,25,0,14,6,11
1963,24018,1280129,56,27,1957,7,female,391.0,30,19,13,34,13,20,0,14
1964,26769,1447563,67,8,1946,10,female,322.0,35,29,0,0,0,0,0,0
1965,58172,1372089,39,18,1974,12,male,205.0,110,82,1131,242,1131,242,0,0
1966,60887,1430180,21,11,1992,9,male,912.0,124,114,70,1487,22,1362,48,125
1967,16405,2091707,24,26,1989,5,female,529.0,20,8,0,1,0,1,0,0
1968,16939,2028220,59,26,1954,7,female,1844.0,19,7,2,4,2,4,0,0
1969,82567,1093081,14,14,1999,4,female,465.0,296,171,34,57,31,51,3,6
1970,17636,1543394,38,14,1975,2,male,510.0,20,3,263,35,262,30,1,5
1971,73697,2121473,27,19,1986,3,male,430.0,204,183,53,275,50,225,3,50
1972,12389,2018860,27,16,1986,3,male,27.0,13,9,0,0,0,0,0,0
1973,61781,1018055,14,21,1999,3,female,528.0,125,64,40,2,40,2,0,0
1974,40831,1665586,59,17,1954,10,female,311.0,61,42,86,98,0,21,86,77
1975,7050,1902568,20,1,1993,2,female,231.0,5,4,2,2,2,2,0,0
1976,21996,1706721,55,1,1958,8,male,75.0,27,14,9,16,9,12,0,4
1977,5433,2102981,25,20,1988,11,male,19.0,3,3,1,0,1,0,0,0
1978,25178,1577017,17,13,1996,3,male,150.0,33,32,0,0,0,0,0,0
1979,41726,1629679,19,21,1994,9,male,346.0,62,54,9,0,8,0,1,0
1980,78470,1464575,16,18,1997,5,male,436.0,241,129,11,78,2,6,9,72
1981,38891,1692271,17,25,1996,7,male,58.0,56,31,26,5,0,1,26,4
1982,28537,1284162,49,10,1964,7,male,495.0,37,20,0,0,0,0,0,0
1983,14122,2156718,39,24,1974,9,female,282.0,15,7,22,3,0,1,22,2
1984,89534,1077237,24,6,1989,12,female,797.0,476,274,46,128,46,100,0,28
1985,71141,1885707,14,25,1999,6,male,191.0,189,172,0,3,0,3,0,0
1986,85135,1031401,23,3,1990,1,male,657.0,345,286,0,29,0,21,0,8
1987,40645,1315002,21,26,1992,6,female,435.0,61,45,20,1,20,1,0,0
1988,98776,1807752,16,15,1997,1,female,885.0,2502,1315,1870,883,40,240,1830,643
1989,82732,1060431,108,1,1905,1,male,394.0,301,272,91,44,0,5,91,39
1990,73737,1049210,19,1,1994,3,female,451.0,198,148,71,251,71,119,0,132
1991,34055,1202839,62,8,1951,12,male,217.0,47,29,14,1,14,1,0,0
1992,87722,2081983,22,17,1991,6,female,185.0,393,301,125,160,125,118,0,42
1993,3009,1867109,51,18,1962,12,male,384.0,1,0,0,0,0,0,0,0
1994,31215,1039332,45,5,1968,10,male,72.0,40,35,421,215,421,143,0,72
1995,86149,1470707,20,14,1993,11,male,808.0,362,139,0,0,0,0,0,0
1996,49898,1013253,56,25,1957,8,female,274.0,83,50,25,348,25,107,0,241
1997,29518,1806485,23,29,1990,5,male,278.0,39,37,0,8,0,5,0,3
1998,49372,1877905,24,18,1989,10,male,683.0,84,8,0,0,0,0,0,0
1999,22517,1995020,24,5,1989,10,male,325.0,28,19,0,8,0,1,0,7
2000,74143,1010025,20,7,1993,2,male,409.0,209,173,0,25,0,25,0,0
2001,92486,2033478,102,1,1911,1,male,1246.0,637,533,70,44,70,35,0,9
2002,7374,1933250,18,1,1995,11,female,441.0,6,2,0,0,0,0,0,0
2003,1913,1661265,49,3,1964,12,female,29.0,0,0,10,17,10,4,0,13
2004,94469,1246481,14,13,1999,5,female,137.0,771,681,85,198,85,129,0,69
2005,67584,1156243,53,20,1960,10,female,2226.0,160,76,10,62,9,52,1,10
2006,77817,1272662,16,3,1997,8,female,890.0,238,75,104,72,102,43,2,29
2007,68779,2141174,20,20,1993,9,female,44.0,166,152,41,176,37,100,4,76
2008,75736,1851830,16,24,1997,12,female,312.0,218,108,52,0,52,0,0,0
2009,67557,1538290,113,25,1900,2,male,1819.0,159,90,8,21,0,15,8,6
2010,34438,1731991,39,31,1974,1,female,295.0,47,31,507,19,507,18,0,1
2011,53899,1421207,18,27,1995,10,male,266.0,97,94,33,7,29,5,4,2
2012,59550,1907932,64,30,1949,1,female,579.0,119,83,5,2,0,2,5,0
2013,3176,1009904,25,1,1988,1,female,20.0,1,0,1,1,0,0,1,1
2014,35492,1014168,18,25,1995,5,female,487.0,51,25,0,0,0,0,0,0
2015,88349,1280097,15,16,1998,11,male,156.0,412,365,9,8,9,6,0,2
2016,81703,1329306,18,13,1995,9,male,646.0,285,226,86,1,86,1,0,0
2017,77246,1106070,68,4,1945,12,male,37.0,237,229,0,13,0,10,0,3
2018,49019,1859378,27,10,1986,6,female,187.0,81,66,73,49,73,28,0,21
2019,57657,1167316,29,16,1984,11,male,323.0,108,97,14,31,13,15,1,16
2020,7566,1309677,27,18,1986,8,male,260.0,6,5,0,0,0,0,0,0
2021,28610,1718386,75,14,1938,12,male,1177.0,38,8,1,0,0,0,1,0
2022,32708,2138421,29,21,1984,3,female,157.0,45,24,1,3,1,2,0,1
2023,86148,1886216,18,16,1995,9,female,193.0,363,77,0,0,0,0,0,0
2024,62398,2083798,18,20,1995,10,female,447.0,134,46,1,7,1,0,0,7
2025,92902,1206405,19,23,1994,9,male,383.0,597,381,669,470,261,234,408,236
2026,4845,1459203,18,5,1995,10,female,60.0,2,1,50,0,50,0,0,0
2027,29399,1322117,32,18,1981,10,female,93.0,38,28,216,92,216,71,0,21
2028,47281,1699712,28,14,1985,2,female,28.0,76,27,121,187,121,167,0,20
2029,47814,2154103,30,27,1983,12,male,489.0,77,12,7,1,7,1,0,0
2030,86374,1117604,20,27,1993,10,female,410.0,380,191,10,17,1,15,9,2
2031,71217,1104100,28,13,1985,2,male,570.0,187,136,0,0,0,0,0,0
2032,66295,1863052,24,10,1989,11,male,447.0,151,120,0,0,0,0,0,0
2033,90204,2172970,18,12,1995,1,female,342.0,513,96,2,24,2,18,0,6
2034,11328,1315340,21,1,1992,1,male,165.0,11,5,8,1,8,0,0,1
2035,18204,2088395,22,31,1991,12,female,394.0,21,15,19,174,19,99,0,75
2036,12750,1414220,28,1,1985,10,male,157.0,13,11,1,0,1,0,0,0
2037,30245,1093148,33,9,1980,5,male,242.0,41,30,0,0,0,0,0,0
2038,18397,1187615,18,2,1995,12,male,34.0,22,18,0,0,0,0,0,0
2039,87927,2050111,101,4,1912,5,male,792.0,396,346,426,155,426,150,0,5
2040,36159,1984411,108,10,1905,6,male,1028.0,50,19,37,34,37,28,0,6
2041,52665,2070976,22,25,1991,9,male,306.0,92,61,9,12,9,7,0,5
2042,29523,1022130,25,13,1988,11,male,184.0,39,31,0,0,0,0,0,0
2043,60025,1974459,30,8,1983,6,female,242.0,118,84,119,71,101,45,18,26
2044,36478,2082116,19,12,1994,12,male,490.0,52,43,0,0,0,0,0,0
2045,41913,2037283,34,30,1979,6,female,153.0,62,49,22,20,22,8,0,12
2046,77526,1378843,23,20,1990,12,female,447.0,237,200,17,165,17,135,0,30
2047,17885,1988337,18,20,1995,10,male,353.0,21,17,1,0,0,0,1,0
2048,51156,1904231,44,25,1969,2,female,835.0,85,48,172,121,152,90,20,31
2049,71351,1041310,22,2,1991,3,male,281.0,184,54,2,3,2,2,0,1
2050,6863,1781155,59,15,1954,8,female,267.0,5,3,0,1,0,1,0,0
2051,37022,1640753,78,22,1935,2,male,311.0,53,39,14,4,0,1,14,3
2052,73578,1472384,26,3,1987,5,female,73.0,198,97,25,65,17,48,8,17
2053,30786,1443605,14,12,1999,3,female,258.0,40,28,13,0,13,0,0,0
2054,62369,1112364,36,12,1977,10,male,265.0,130,90,1,3,0,2,1,1
2055,68125,1241852,36,2,1977,6,female,1908.0,161,61,607,1349,249,825,358,524
2056,57440,1461363,37,6,1976,6,female,363.0,108,78,2,10,2,10,0,0
2057,95594,1728350,103,2,1910,1,male,910.0,882,530,269,411,185,124,84,287
2058,75237,1656221,19,17,1994,7,male,369.0,213,168,1,0,0,0,1,0
2059,11225,2143616,43,27,1970,11,female,467.0,11,4,2,4,2,4,0,0
2060,19208,1574202,26,3,1987,9,male,324.0,23,17,7,34,7,33,0,1
2061,92524,1720953,103,14,1910,11,male,706.0,593,287,90,230,90,212,0,18
2062,8129,2015258,47,11,1966,5,male,135.0,6,6,2,1,0,0,2,1
2063,65134,1978117,53,24,1960,4,female,328.0,140,98,3287,510,3287,224,0,286
2064,46197,1197438,16,8,1997,7,female,528.0,72,29,326,12,326,11,0,1
2065,2071,1274374,17,17,1996,8,female,179.0,1,1,0,0,0,0,0,0
2066,81748,2145532,37,19,1976,11,female,314.0,285,195,105,336,80,131,25,205
2067,83942,1121975,32,11,1981,10,female,630.0,316,76,375,587,183,227,192,360
2068,64096,2137471,108,16,1905,1,female,65.0,137,125,296,15,235,12,61,3
2069,69273,1231969,20,3,1993,3,male,586.0,175,121,0,2,0,0,0,2
2070,2579,1186244,29,18,1984,2,male,365.0,1,1,0,0,0,0,0,0
2071,40895,1112537,15,8,1998,1,male,132.0,60,32,132,63,132,39,0,24
2072,29905,1374282,106,25,1907,7,male,70.0,39,38,29,1,25,1,4,0
2073,37684,2010019,22,6,1991,6,female,234.0,55,20,2,4,2,4,0,0
2074,2452,2112706,26,1,1987,1,female,572.0,1,0,0,0,0,0,0,0
2075,3528,1276097,28,26,1985,11,female,141.0,1,0,7,0,7,0,0,0
2076,74686,1123335,16,24,1997,5,male,78.0,212,124,46,84,46,69,0,15
2077,84518,1626150,19,4,1994,6,female,496.0,329,162,27,23,0,14,27,9
2078,31406,1568310,33,24,1980,1,male,456.0,42,27,0,0,0,0,0,0
2079,11693,1029483,42,25,1971,11,male,564.0,12,3,0,7,0,7,0,0
2080,52324,1278717,25,3,1988,2,male,257.0,93,72,0,3,0,3,0,0
2081,80832,1490632,17,2,1996,6,male,473.0,273,236,128,12,115,6,13,6
2082,78616,1514626,23,1,1990,1,male,470.0,250,170,34,65,34,49,0,16
2083,88515,1941757,17,8,1996,5,male,500.0,439,355,37,14,20,5,17,9
2084,98441,1124345,108,15,1905,3,female,1614.0,3008,1191,319,742,205,493,114,249
2085,78152,1034411,14,25,1999,5,female,46.0,250,29,0,1,0,1,0,0
2086,83628,1362101,106,2,1907,3,male,1989.0,315,171,55,3,49,1,6,2
2087,96552,1554697,16,3,1997,8,male,535.0,1265,383,269,411,269,268,0,143
2088,26718,1679425,54,14,1959,6,male,971.0,34,15,0,4,0,4,0,0
2089,20932,1998199,25,12,1988,1,male,228.0,25,17,10,16,10,12,0,4
2090,12683,1653326,55,22,1958,10,male,920.0,13,4,1,0,0,0,1,0
2091,24415,1664593,40,23,1973,8,female,79.0,29,22,146,106,0,13,146,93
2092,73817,1009656,17,28,1996,8,male,125.0,200,195,120,10,120,10,0,0
2093,25556,1208308,32,28,1981,11,male,462.0,32,6,1,0,1,0,0,0
2094,44335,1258154,30,12,1983,2,male,434.0,69,41,0,0,0,0,0,0
2095,88936,1207797,64,8,1949,6,female,2361.0,429,278,442,225,326,80,116,145
2096,11439,2163532,15,31,1998,8,female,192.0,11,10,30,1,29,0,1,1
2097,66292,1721739,21,16,1992,10,male,795.0,154,134,0,1,0,1,0,0
2098,74952,1860457,66,10,1947,8,female,1744.0,209,78,270,44,47,29,223,15
2099,7475,1375401,23,6,1990,9,male,63.0,7,4,0,0,0,0,0,0
2100,15848,1529680,35,27,1978,8,male,949.0,18,6,1,2,0,0,1,2
2101,78577,1530144,25,29,1988,4,male,813.0,241,197,26,3,26,3,0,0
2102,70799,1595489,22,4,1991,5,female,494.0,179,93,67,114,67,110,0,4
2103,62736,1353127,20,19,1993,12,male,436.0,133,99,23,34,7,4,16,30
2104,40438,1205360,13,19,2000,2,male,64.0,60,44,4,0,4,0,0,0
2105,2837,1840761,40,19,1973,12,male,277.0,1,1,0,0,0,0,0,0
2106,59563,1248182,30,3,1983,7,female,472.0,117,41,5,1,5,0,0,1
2107,56965,1645728,36,30,1977,5,female,142.0,106,24,100,51,100,32,0,19
2108,34608,1650287,34,29,1979,8,male,217.0,49,35,0,0,0,0,0,0
2109,39193,1401939,58,6,1955,5,female,141.0,56,46,869,215,0,30,869,185
2110,45208,1199330,27,10,1986,7,male,525.0,73,36,0,2,0,2,0,0
2111,97506,1439823,18,3,1995,1,female,588.0,1800,833,282,1264,18,725,264,539
2112,87179,2086325,26,8,1987,7,female,553.0,385,296,0,0,0,0,0,0
2113,35708,1846398,26,31,1987,7,male,250.0,51,22,1,0,1,0,0,0
2114,22521,1164020,25,3,1988,2,male,258.0,28,22,0,0,0,0,0,0
2115,39254,2158160,22,17,1991,11,male,600.0,59,27,0,5,0,4,0,1
2116,83087,2101632,19,23,1994,3,male,1386.0,299,192,1415,1527,926,458,489,1069
2117,90504,2135953,92,25,1921,12,male,1913.0,517,226,58,15,8,8,50,7
2118,84082,1074222,14,4,1999,1,male,35.0,319,243,1275,1072,559,751,716,321
2119,9926,2035741,50,4,1963,4,male,491.0,10,9,0,0,0,0,0,0
2120,4525,1574569,21,21,1992,3,female,670.0,2,1,1,0,1,0,0,0
2121,20837,1480908,78,17,1935,2,female,1613.0,25,13,4,0,0,0,4,0
2122,29984,1836467,56,27,1957,12,female,261.0,39,19,76,13,0,2,76,11
2123,52761,1628907,32,11,1981,9,male,703.0,93,51,22,11,22,9,0,2
2124,64636,1714661,30,23,1983,8,female,279.0,143,53,12,36,12,25,0,11
2125,11891,1454695,38,10,1975,1,male,1789.0,12,12,3,0,0,0,3,0
2126,87559,1673550,20,2,1993,10,male,462.0,395,293,48,16,48,16,0,0
2127,10961,1337291,30,4,1983,8,female,217.0,11,5,0,0,0,0,0,0
2128,2858,1048278,40,11,1973,8,male,57.0,1,1,0,0,0,0,0,0
2129,51845,1307344,31,12,1982,10,female,283.0,88,49,25,16,25,7,0,9
2130,49535,1335499,27,27,1986,9,male,229.0,82,63,1,10,1,9,0,1
2131,63910,1419734,47,23,1966,5,male,458.0,139,79,66,116,0,33,66,83
2132,98152,1083386,68,16,1945,4,female,1559.0,4499,582,23,51,23,38,0,13
2133,8729,1660151,20,10,1993,11,female,383.0,8,8,0,0,0,0,0,0
2134,34788,1035749,21,15,1992,2,male,142.0,48,38,2,0,2,0,0,0
2135,25673,1244755,35,14,1978,2,female,397.0,33,12,2,5,2,5,0,0
2136,362,1633284,21,1,1992,1,male,12.0,0,0,0,0,0,0,0,0
2137,49371,1650917,24,19,1989,9,male,332.0,84,61,0,0,0,0,0,0
2138,76871,1920223,52,4,1961,8,female,776.0,224,176,133,45,117,22,16,23
2139,2093,2030230,18,12,1995,3,male,186.0,1,0,0,0,0,0,0,0
2140,11696,2050119,41,5,1972,7,male,292.0,12,7,0,1,0,0,0,1
2141,57397,1841063,58,14,1955,3,female,1682.0,110,38,2,23,0,1,2,22
2142,88480,1601230,103,2,1910,2,female,458.0,439,99,28,20,28,16,0,4
2143,13071,1381603,23,18,1990,8,male,23.0,13,12,5,1,5,1,0,0
2144,96901,1646470,19,10,1994,10,male,84.0,1123,443,1854,3320,1243,1982,611,1338
2145,67183,1847402,23,17,1990,6,female,256.0,154,85,525,301,520,134,5,167
2146,56315,1191335,17,27,1996,1,female,148.0,102,49,1579,350,1579,73,0,277
2147,17817,1752765,39,26,1974,6,female,103.0,21,9,0,0,0,0,0,0
2148,90085,1401126,14,6,1999,7,male,104.0,502,471,0,23,0,1,0,22
2149,72709,1120727,57,7,1956,10,female,1016.0,191,82,44,52,2,27,42,25
2150,8846,1619096,27,2,1986,8,female,423.0,8,5,0,0,0,0,0,0
2151,29961,2113331,64,15,1949,10,male,86.0,39,21,58,41,48,20,10,21
2152,62701,1144825,73,5,1940,12,male,934.0,133,73,19,26,0,3,19,23
2153,95538,1154245,26,9,1987,9,female,684.0,867,756,200,252,199,189,1,63
2154,37734,1453651,33,27,1980,10,male,643.0,54,19,3,23,3,3,0,20
2155,76625,1264210,25,30,1988,6,male,232.0,222,151,28,2,28,2,0,0
2156,16313,1509691,17,8,1996,6,male,252.0,20,15,0,0,0,0,0,0
2157,29508,1125423,23,9,1990,11,male,1111.0,39,1,0,2,0,0,0,2
2158,19273,1990698,24,20,1989,1,male,456.0,22,10,10,2,10,0,0,2
2159,3401,1792914,43,3,1970,1,male,1499.0,1,1,3,0,1,0,2,0
2160,91832,1152125,100,1,1913,1,female,1195.0,525,131,480,934,480,710,0,224
2161,7216,1412233,33,29,1980,5,male,28.0,5,4,20,1,20,1,0,0
2162,8712,2012130,17,8,1996,2,male,11.0,8,7,0,0,0,0,0,0
2163,56373,1425953,22,10,1991,6,male,515.0,105,84,0,0,0,0,0,0
2164,17209,1543461,74,23,1939,3,male,869.0,20,10,9,1,9,1,0,0
2165,24781,1490202,14,5,1999,2,male,35.0,31,22,3,7,0,2,3,5
2166,13295,1773136,38,27,1975,12,male,624.0,13,8,19,3,19,2,0,1
2167,37413,2109921,55,9,1958,10,female,409.0,53,24,1546,220,1546,151,0,69
2168,29077,1859394,44,12,1969,10,female,621.0,38,11,16,25,16,21,0,4
2169,20805,1475360,22,16,1991,8,female,64.0,25,23,2,9,2,9,0,0
2170,30017,2152481,19,9,1994,9,male,1123.0,39,24,123,197,31,176,92,21
2171,59676,1505626,57,12,1956,11,female,1262.0,116,48,11,199,1,45,10,154
2172,92376,1791523,103,17,1910,9,female,1037.0,634,246,33,17,0,9,33,8
2173,2618,2193460,30,1,1983,4,male,612.0,1,0,0,0,0,0,0,0
2174,70215,1315572,23,1,1990,1,male,862.0,178,78,0,0,0,0,0,0
2175,53080,1129761,50,31,1963,3,male,30.0,91,73,307,497,307,312,0,185
2176,24138,1256436,53,12,1960,7,female,307.0,29,22,24,4,24,4,0,0
2177,91650,1316263,48,27,1965,5,male,1666.0,552,114,167,449,167,174,0,275
2178,31789,2048292,68,7,1945,8,male,742.0,42,25,5,5,0,0,5,5
2179,59233,2171841,18,1,1995,11,male,502.0,120,111,0,2,0,2,0,0
2180,45941,1878696,57,20,1956,3,male,572.0,73,56,46,23,7,18,39,5
2181,56081,2052941,55,2,1958,1,,1977.0,104,71,113,103,113,74,0,29
2182,33651,1304887,66,8,1947,10,male,332.0,46,35,0,0,0,0,0,0
2183,55933,1381306,108,29,1905,12,male,248.0,103,80,40,13,1,8,39,5
2184,10678,1298501,50,11,1963,11,female,629.0,9,3,28,2,3,2,25,0
2185,90016,1613280,24,22,1989,10,female,256.0,468,352,1046,330,1044,217,2,113
2186,22817,1612716,30,4,1983,7,female,314.0,28,14,6,24,4,4,2,20
2187,8026,2095595,15,18,1998,11,female,62.0,7,5,1,0,1,0,0,0
2188,16691,1156404,69,12,1944,7,female,149.0,19,16,0,0,0,0,0,0
2189,64871,1423064,29,5,1984,8,female,299.0,141,103,78,2,58,2,20,0
2190,9061,2029021,45,7,1968,2,male,338.0,8,3,1,0,1,0,0,0
2191,1759,1174736,62,26,1951,10,male,21.0,0,0,1,0,1,0,0,0
2192,45413,1010754,63,9,1950,1,male,402.0,71,63,2,5,0,1,2,4
2193,48648,1161088,51,10,1962,8,male,1221.0,81,31,7,2,0,0,7,2
2194,13307,1125176,52,17,1961,12,male,368.0,13,9,21,0,21,0,0,0
2195,15284,2087688,77,4,1936,4,female,1562.0,16,2,20,0,0,0,20,0
2196,64555,1406154,21,1,1992,5,male,216.0,140,90,7,0,4,0,3,0
2197,24836,1022113,68,22,1945,1,female,28.0,31,17,5,9,5,5,0,4
2198,75619,1201921,21,18,1992,6,female,1471.0,217,68,28,33,0,17,28,16
2199,86691,1906789,15,29,1998,8,male,432.0,367,284,99,42,82,23,17,19
2200,32051,1789016,31,25,1982,11,male,241.0,42,15,25,2,25,1,0,1
2201,71241,2166043,38,5,1975,5,male,403.0,189,165,0,4,0,3,0,1
2202,70978,1759530,19,15,1994,11,female,650.0,177,58,233,56,233,52,0,4
2203,76163,1995416,19,28,1994,6,male,135.0,217,154,7038,3479,5610,1030,1428,2449
2204,79807,1834163,47,28,1966,9,male,390.0,259,54,134,70,132,46,2,24
2205,21752,1500767,56,29,1957,6,male,706.0,27,21,2,2,2,2,0,0
2206,12315,1164408,23,27,1990,10,male,758.0,13,10,0,0,0,0,0,0
2207,39702,1325047,39,27,1974,12,male,408.0,59,46,11,5,11,5,0,0
2208,17754,1981738,25,1,1988,1,male,103.0,21,16,0,4,0,1,0,3
2209,35115,2111662,30,15,1983,5,female,329.0,48,42,25,9,25,9,0,0
2210,47881,1284146,65,29,1948,2,male,312.0,78,41,14,13,2,5,12,8
2211,28986,1627026,64,2,1949,8,female,1695.0,38,11,9,8,9,5,0,3
2212,47882,1075084,26,22,1987,10,male,71.0,77,73,14,14,14,8,0,6
2213,51877,2148975,77,23,1936,1,female,1443.0,89,40,32,0,32,0,0,0
2214,63278,1419287,21,10,1992,2,male,536.0,139,125,0,0,0,0,0,0
2215,20406,1514217,17,14,1996,7,male,631.0,24,11,58,7,5,4,53,3
2216,66457,1284135,14,4,1999,5,male,228.0,154,103,3,1,0,0,3,1
2217,45892,2190366,54,5,1959,1,female,309.0,73,54,37,0,37,0,0,0
2218,6883,1710158,66,30,1947,6,male,220.0,5,2,0,0,0,0,0,0
2219,24753,2161361,20,20,1993,5,male,315.0,31,21,2,0,2,0,0,0
2220,70779,1454065,53,13,1960,10,female,354.0,176,132,58,43,58,36,0,7
2221,6469,1901878,30,9,1983,9,male,33.0,4,4,61,2,43,1,18,1
2222,22666,1763427,16,14,1997,2,male,29.0,28,22,1,0,1,0,0,0
2223,1485,1426370,48,1,1965,11,male,3.0,0,0,0,0,0,0,0,0
2224,64649,1749477,52,20,1961,5,male,329.0,142,77,14,3,0,0,14,3
2225,26132,1824878,17,19,1996,7,male,301.0,33,15,27,9,27,9,0,0
2226,78631,1246342,53,18,1960,3,female,369.0,249,159,39,13,39,8,0,5
2227,46973,1095964,47,7,1966,5,female,381.0,74,18,20,2,3,2,17,0
2228,3499,1137497,23,1,1990,1,male,38.0,1,1,5,1,5,0,0,1
2229,42131,1117415,22,26,1991,3,male,497.0,64,48,59,8,59,2,0,6
2230,53062,1039539,48,10,1965,3,female,1752.0,92,23,233,297,233,221,0,76
2231,54111,1218038,30,20,1983,12,male,597.0,96,82,105,46,90,36,15,10
2232,31764,1253692,66,11,1947,8,female,1111.0,42,33,4,1,3,0,1,1
2233,63480,2164056,26,8,1987,7,male,1231.0,136,77,2,11,2,10,0,1
2234,18234,1493847,24,1,1989,9,female,1185.0,21,7,26,0,26,0,0,0
2235,9219,2131746,53,15,1960,4,female,5.0,8,7,6,1,4,0,2,1
2236,75687,1976587,50,31,1963,7,male,526.0,221,164,42,82,9,19,33,63
2237,47697,2134354,58,30,1955,11,male,100.0,77,45,1,3,1,1,0,2
2238,84011,1313764,43,6,1970,7,female,1804.0,309,139,529,918,511,490,18,428
2239,81175,1987379,36,7,1977,7,male,651.0,283,279,0,2,0,0,0,2
2240,89884,1977191,25,24,1988,6,female,323.0,476,392,396,507,280,208,116,299
2241,88367,1765127,94,22,1919,8,female,758.0,430,90,10,23,10,21,0,2
2242,85410,1036355,108,22,1905,7,male,1771.0,350,205,12,165,12,96,0,69
2243,77039,1917016,18,25,1995,6,male,594.0,230,133,484,64,410,30,74,34
2244,43382,1586861,63,18,1950,3,female,1562.0,65,33,2514,309,2497,256,17,53
2245,65534,2169906,27,5,1986,9,female,724.0,149,35,6,18,6,16,0,2
2246,21484,1071825,57,29,1956,1,male,165.0,26,22,0,1,0,0,0,1
2247,7909,1878258,63,4,1950,2,male,1788.0,7,0,0,0,0,0,0,0
2248,64223,1580265,15,6,1998,7,female,182.0,142,12,0,0,0,0,0,0
2249,76996,1393108,18,18,1995,7,female,91.0,229,89,367,377,156,141,211,236
2250,24348,1861003,16,25,1997,6,male,485.0,30,24,78,5,78,5,0,0
2251,24862,1242235,25,14,1988,2,male,39.0,31,22,7,15,7,14,0,1
2252,42450,1347167,17,13,1996,3,female,297.0,62,33,1585,0,1585,0,0,0
2253,31057,1750831,39,1,1974,4,male,549.0,41,35,68,1,31,1,37,0
2254,91211,1340837,18,19,1995,2,male,433.0,552,468,3,11,3,5,0,6
2255,81310,2130377,21,16,1992,7,male,871.0,288,115,4,50,4,48,0,2
2256,83668,1625003,50,7,1963,6,female,1846.0,317,95,73,63,73,31,0,32
2257,98660,1845678,20,7,1993,2,female,1669.0,3765,950,816,1382,619,1035,197,347
2258,55550,1947204,17,1,1996,1,male,595.0,104,59,3,0,3,0,0,0
2259,23541,1173458,14,15,1999,3,male,7.0,30,26,1,1,0,0,1,1
2260,20222,1782688,57,10,1956,3,female,319.0,24,6,8,2,0,1,8,1
2261,43856,1388348,51,26,1962,9,male,203.0,68,48,18,8,18,8,0,0
2262,23656,1248297,46,28,1967,10,male,748.0,29,11,1,3,1,2,0,1
2263,22672,1967471,24,12,1989,5,male,177.0,28,9,1,0,1,0,0,0
2264,6518,1382205,15,16,1998,4,male,16.0,5,4,0,0,0,0,0,0
2265,89937,1210948,29,18,1984,11,female,109.0,457,431,607,168,576,60,31,108
2266,52827,2009084,15,5,1998,7,male,430.0,91,67,35,26,33,16,2,10
2267,70287,1872572,31,2,1982,9,male,641.0,180,110,1,0,0,0,1,0
2268,63418,1633483,32,3,1981,9,male,339.0,135,127,1,1,1,0,0,1
2269,25362,1304288,37,3,1976,6,female,433.0,33,20,0,2,0,1,0,1
2270,46435,1670173,31,15,1982,4,male,606.0,74,25,0,0,0,0,0,0
2271,58279,1190221,28,11,1985,9,male,39.0,112,92,0,1,0,0,0,1
2272,89983,1521766,25,29,1988,2,male,255.0,464,362,779,431,779,385,0,46
2273,41901,1624586,33,17,1980,5,female,319.0,63,15,20,115,20,78,0,37
2274,42301,1432888,23,13,1990,11,female,619.0,64,27,160,56,160,16,0,40
2275,38625,1438792,53,25,1960,2,male,564.0,56,26,3,7,0,1,3,6
2276,59770,1731155,91,22,1922,2,male,224.0,117,89,21,9,21,9,0,0
2277,62734,1069176,61,28,1952,1,male,224.0,132,88,23,72,0,8,23,64
2278,2463,1487331,26,4,1987,4,male,397.0,1,1,0,0,0,0,0,0
2279,92205,1768042,27,28,1986,2,male,339.0,624,484,5,5,5,5,0,0
2280,86486,1987417,48,25,1965,4,male,1410.0,363,137,24,45,14,15,10,30
2281,8244,1334707,62,1,1951,2,male,11.0,7,3,3,1,3,0,0,1
2282,77203,1677619,23,14,1990,8,male,749.0,237,193,0,0,0,0,0,0
2283,94956,1368621,28,27,1985,5,female,513.0,787,446,1635,760,437,295,1198,465
2284,35808,1059950,56,16,1957,2,male,1946.0,51,9,3,1,1,1,2,0
2285,56234,1067584,21,9,1992,8,male,391.0,103,95,346,41,299,5,47,36
2286,79347,1282050,18,14,1995,8,male,679.0,259,180,5,519,5,404,0,115
2287,26189,2187077,33,4,1980,10,female,601.0,32,26,35,21,35,17,0,4
2288,44588,1380824,26,29,1987,9,male,668.0,69,38,6,0,6,0,0,0
2289,39126,1021153,30,10,1983,5,female,537.0,57,28,187,50,178,24,9,26
2290,37493,2122090,25,12,1988,11,male,1942.0,55,25,0,3,0,0,0,3
2291,71619,1290994,108,1,1905,1,male,175.0,183,132,25,18,1,4,24,14
2292,87755,1390983,22,30,1991,1,female,440.0,396,139,147,223,147,172,0,51
2293,12937,1320390,33,8,1980,4,male,352.0,14,2,3,0,0,0,3,0
2294,45461,2026922,49,26,1964,1,male,269.0,71,33,3,4,0,3,3,1
2295,81449,1027523,94,16,1919,6,male,2132.0,278,154,18,4,1,1,17,3
2296,66089,1199793,20,10,1993,1,male,545.0,146,95,272,33,2,12,270,21
2297,60798,1684982,38,6,1975,12,female,72.0,123,37,37,68,25,47,12,21
2298,34362,2148237,33,20,1980,1,female,552.0,46,27,138,122,137,76,1,46
2299,63759,1566697,102,20,1911,9,male,305.0,137,121,24,35,24,25,0,10
2300,26534,1112629,23,11,1990,4,male,472.0,34,19,0,1,0,0,0,1
2301,69428,1743730,59,23,1954,12,male,96.0,174,162,2,5,2,3,0,2
2302,80671,1813100,68,30,1945,9,female,539.0,263,200,48,14,48,10,0,4
2303,13411,1973047,22,5,1991,12,female,229.0,14,10,41,38,22,9,19,29
2304,70003,1477515,56,18,1957,6,female,1888.0,174,55,250,415,224,352,26,63
2305,11626,1502407,26,3,1987,3,female,129.0,12,7,0,0,0,0,0,0
2306,37392,1342384,48,20,1965,10,male,111.0,53,52,493,13,493,9,0,4
2307,22991,1577119,25,1,1988,3,female,376.0,28,12,33,248,32,120,1,128
2308,8181,1966289,28,7,1985,12,female,18.0,7,7,2,2,2,2,0,0
2309,16187,1714273,69,6,1944,12,male,1287.0,18,8,39,10,39,10,0,0
2310,14955,1619606,17,20,1996,10,female,222.0,17,6,3,0,3,0,0,0
2311,51473,1680852,24,25,1989,9,male,218.0,90,70,1,7,1,4,0,3
2312,46558,1888022,28,24,1985,6,male,348.0,74,69,1,0,1,0,0,0
2313,43479,1981487,27,4,1986,4,male,298.0,67,33,0,0,0,0,0,0
2314,63702,1344746,31,3,1982,12,male,415.0,138,58,16,16,16,13,0,3
2315,69514,1210550,34,21,1979,4,male,798.0,173,123,6,16,6,14,0,2
2316,90589,2065786,18,25,1995,9,male,282.0,486,270,91,159,75,100,16,59
2317,38337,1675285,14,13,1999,4,female,255.0,56,28,0,1,0,0,0,1
2318,51365,1363961,26,1,1987,1,male,609.0,89,40,0,0,0,0,0,0
2319,31434,1669445,42,7,1971,5,male,425.0,43,23,0,1,0,0,0,1
2320,58282,2051741,29,9,1984,7,female,338.0,113,92,0,0,0,0,0,0
2321,46026,2005692,28,31,1985,3,female,97.0,71,70,82,106,38,52,44,54
2322,11731,1590943,51,5,1962,7,male,1263.0,12,2,0,1,0,1,0,0
2323,95073,1802416,25,7,1988,5,male,511.0,873,752,0,0,0,0,0,0
2324,48659,1793512,18,5,1995,6,male,206.0,80,72,7,5,7,5,0,0
2325,88393,1445670,20,13,1993,8,male,221.0,416,313,14,6,14,6,0,0
2326,86568,1286976,21,5,1992,5,male,502.0,373,320,43,41,43,38,0,3
2327,3011,1986508,50,14,1963,2,female,704.0,1,0,0,0,0,0,0,0
2328,61158,1974976,16,8,1997,3,female,146.0,125,79,0,0,0,0,0,0
2329,11680,1138783,36,15,1977,12,male,809.0,12,4,0,4,0,1,0,3
2330,79724,1580574,21,11,1992,10,male,359.0,255,214,80,172,80,139,0,33
2331,8686,1186450,13,14,2000,4,female,173.0,8,7,0,0,0,0,0,0
2332,95792,1557179,17,8,1996,5,male,554.0,884,472,727,759,267,397,460,362
2333,10407,1165406,28,13,1985,11,male,1.0,9,9,4,9,4,5,0,4
2334,89627,1787873,18,22,1995,3,female,360.0,458,314,82,39,60,32,22,7
2335,64988,1413536,27,24,1986,2,female,267.0,140,102,212,37,195,31,17,6
2336,93248,1520999,22,8,1991,2,male,323.0,643,574,9,8,9,6,0,2
2337,9142,1506351,34,19,1979,1,male,436.0,8,7,3,14,0,1,3,13
2338,14353,1362584,22,25,1991,10,male,617.0,17,8,0,2,0,1,0,1
2339,36527,1286657,23,1,1990,5,female,223.0,53,30,0,0,0,0,0,0
2340,15996,1074450,36,28,1977,9,male,302.0,18,12,4,9,4,7,0,2
2341,77094,2084758,31,19,1982,10,male,1991.0,225,131,1018,1594,385,817,633,777
2342,26070,1051254,37,17,1976,2,male,585.0,32,5,20,0,20,0,0,0
2343,23293,1906354,29,12,1984,3,male,151.0,29,22,0,2,0,2,0,0
2344,1784,1760214,31,21,1982,3,male,307.0,0,0,2,0,0,0,2,0
2345,87034,1896980,18,10,1995,12,male,250.0,365,291,821,374,598,285,223,89
2346,12709,1388159,27,5,1986,7,male,113.0,14,9,1,5,0,1,1,4
2347,48269,2100410,19,6,1994,2,male,362.0,79,49,0,0,0,0,0,0
2348,81279,2099952,20,30,1993,5,male,362.0,275,145,3,16,0,8,3,8
2349,44130,1651869,41,16,1972,12,male,714.0,68,33,163,55,163,48,0,7
2350,16210,1178814,18,7,1995,7,male,153.0,18,9,54,5,54,2,0,3
2351,73075,2081049,67,30,1946,1,female,1475.0,195,75,917,688,0,247,917,441
2352,65260,1017057,31,14,1982,9,male,364.0,145,56,0,12,0,6,0,6
2353,28334,1619167,19,12,1994,11,female,373.0,38,31,0,0,0,0,0,0
2354,75916,1275256,21,6,1992,1,female,187.0,217,135,149,148,149,47,0,101
2355,37789,1954648,27,1,1986,10,male,363.0,54,35,6,9,0,0,6,9
2356,41585,1904978,15,31,1998,5,female,535.0,62,35,4,0,3,0,1,0
2357,3449,1997669,26,18,1987,1,female,666.0,1,1,4,3,3,2,1,1
2358,69847,1332728,100,3,1913,1,female,1710.0,170,45,72,74,72,34,0,40
2359,13935,1947031,24,16,1989,12,male,402.0,15,12,3,1,0,0,3,1
2360,40818,1464733,52,15,1961,3,female,764.0,60,24,79,41,55,24,24,17
2361,6593,1488281,22,6,1991,2,male,343.0,5,4,0,0,0,0,0,0
2362,87778,1283447,20,19,1993,9,female,354.0,394,238,169,102,169,28,0,74
2363,80994,1547506,28,12,1985,6,male,278.0,269,252,466,77,464,32,2,45
2364,7394,1963016,21,26,1992,11,male,53.0,7,5,0,0,0,0,0,0
2365,36185,1071441,48,30,1965,4,female,334.0,50,15,45,68,43,29,2,39
2366,84857,1256431,16,17,1997,7,female,387.0,335,253,252,394,159,189,93,205
2367,54306,2044228,23,17,1990,3,female,420.0,94,28,477,471,90,226,387,245
2368,43364,2154923,56,8,1957,9,female,357.0,66,45,680,194,680,155,0,39
2369,85031,1788038,18,23,1995,9,female,244.0,332,268,1109,349,610,202,499,147
2370,40481,1184186,58,13,1955,7,male,252.0,61,44,6,1,0,1,6,0
2371,35700,1185657,18,16,1995,1,male,101.0,50,44,1,0,1,0,0,0
2372,47448,1658065,38,26,1975,10,female,260.0,74,35,738,430,738,294,0,136
2373,46195,1021321,61,30,1952,3,female,318.0,71,42,327,154,0,68,327,86
2374,32998,1253023,76,26,1937,11,female,1268.0,44,25,13,5,0,4,13,1
2375,22539,1436344,28,3,1985,2,male,265.0,28,21,0,0,0,0,0,0
2376,1146,1391167,34,28,1979,2,female,15.0,0,0,0,0,0,0,0,0
2377,86585,1135571,23,26,1990,3,male,916.0,365,264,53,6,53,5,0,1
2378,15324,1421938,23,2,1990,1,male,24.0,17,12,27,28,27,16,0,12
2379,72340,1329179,16,11,1997,11,male,24.0,191,116,1,2,1,2,0,0
2380,1646,1377912,65,7,1948,4,female,109.0,0,0,0,0,0,0,0,0
2381,66729,1310007,45,15,1968,12,male,662.0,154,17,23,183,23,139,0,44
2382,59650,2126287,50,14,1963,11,male,267.0,117,110,9,1,9,1,0,0
2383,38783,1440410,14,8,1999,10,male,550.0,56,29,12,9,0,0,12,9
2384,4895,1167496,13,23,2000,1,male,194.0,3,2,0,0,0,0,0,0
2385,56484,1432467,64,23,1949,3,female,830.0,107,14,1,18,0,4,1,14
2386,77395,2150681,23,3,1990,12,male,559.0,238,88,5,7,5,5,0,2
2387,16352,1712111,20,24,1993,1,male,75.0,20,15,0,0,0,0,0,0
2388,42334,1312170,76,5,1937,5,female,1350.0,64,17,205,18,201,13,4,5
2389,13833,1930022,23,11,1990,12,male,233.0,15,9,1,0,1,0,0,0
2390,35522,2099806,21,1,1992,9,male,382.0,51,35,0,0,0,0,0,0
2391,31273,1040272,16,27,1997,2,female,190.0,42,31,0,0,0,0,0,0
2392,80753,1757691,19,3,1994,8,female,502.0,267,183,80,254,80,252,0,2
2393,17714,1265845,21,9,1992,12,male,315.0,21,15,0,5,0,3,0,2
2394,85790,1064372,53,27,1960,1,male,960.0,353,235,145,88,72,47,73,41
2395,11939,1741511,49,18,1964,5,male,427.0,12,6,5,0,0,0,5,0
2396,64985,1400888,36,18,1977,2,male,915.0,144,118,209,81,209,63,0,18
2397,44669,1837492,14,20,1999,3,male,167.0,70,25,11,1,11,1,0,0
2398,31105,1870412,20,5,1993,5,male,50.0,41,31,96,17,96,4,0,13
2399,34968,1545397,48,20,1965,1,female,841.0,48,24,9,1,9,1,0,0
2400,33754,1495559,54,21,1959,2,female,1403.0,47,14,1,5,1,2,0,3
2401,73220,1966449,28,1,1985,1,male,794.0,204,168,0,0,0,0,0,0
2402,7967,1808529,103,10,1910,11,male,142.0,6,3,0,0,0,0,0,0
2403,95795,1447423,25,5,1988,10,female,1771.0,966,527,781,1278,196,829,585,449
2404,82236,1067887,17,9,1996,4,male,224.0,294,235,1,3,1,3,0,0
2405,59349,1911256,58,14,1955,11,male,1975.0,119,35,0,0,0,0,0,0
2406,58933,1586420,39,24,1974,8,female,587.0,114,79,94,109,94,46,0,63
2407,35149,1765868,113,8,1900,7,female,1147.0,49,31,33,18,0,6,33,12
2408,82272,2001347,57,2,1956,6,male,270.0,292,133,2,2,2,2,0,0
2409,1438,1619135,46,18,1967,2,male,307.0,0,0,0,0,0,0,0,0
2410,39008,1317355,61,21,1952,3,female,280.0,56,36,62,1,35,1,27,0
2411,25096,1885775,25,4,1988,4,female,534.0,31,29,115,76,91,34,24,42
2412,7107,1677524,18,22,1995,5,female,367.0,5,4,4,29,4,8,0,21
2413,59035,1910076,22,21,1991,10,female,705.0,113,90,182,4,182,4,0,0
2414,95714,1370493,18,19,1995,4,female,552.0,918,178,500,175,397,98,103,77
2415,66509,2048449,19,6,1994,7,male,353.0,152,118,4,1,4,0,0,1
2416,13915,2167422,29,29,1984,3,female,70.0,15,2,2,1,2,1,0,0
2417,59106,1967671,20,25,1993,8,male,107.0,115,53,453,67,350,33,103,34
2418,41440,1682729,60,16,1953,2,female,1035.0,63,27,1,6,1,6,0,0
2419,35986,1826991,32,16,1981,3,male,102.0,50,22,11,4,11,4,0,0
2420,70272,1495473,74,15,1939,9,female,1687.0,181,87,0,0,0,0,0,0
2421,64914,2192886,13,10,2000,3,female,230.0,140,94,116,55,110,36,6,19
2422,16417,1716565,25,1,1988,1,female,203.0,20,15,0,15,0,9,0,6
2423,22788,1241911,21,16,1992,6,female,24.0,28,21,4,17,4,17,0,0
2424,78911,1418969,18,19,1995,10,male,395.0,245,173,266,134,244,111,22,23
2425,73848,2072960,47,17,1966,9,male,510.0,200,80,150,167,150,137,0,30
2426,52177,1430431,29,27,1984,1,male,404.0,90,57,322,199,322,145,0,54
2427,19351,1791703,20,13,1993,6,female,285.0,23,7,15,18,4,18,11,0
2428,75028,1947696,61,28,1952,4,female,1804.0,209,169,511,174,360,123,151,51
2429,24047,1651156,34,7,1979,10,female,9.0,29,20,15,10,15,9,0,1
2430,27269,1685387,22,27,1991,6,male,164.0,35,26,12,0,12,0,0,0
2431,58749,1862870,23,10,1990,9,female,405.0,115,85,27,54,27,37,0,17
2432,5380,2159808,72,30,1941,9,female,360.0,3,1,0,0,0,0,0,0
2433,74179,2091724,26,26,1987,12,male,889.0,205,140,0,1,0,1,0,0
2434,35531,1893774,23,22,1990,6,female,421.0,51,43,0,0,0,0,0,0
2435,81988,1969126,17,15,1996,12,female,280.0,279,129,515,501,515,264,0,237
2436,6702,1107902,31,17,1982,1,male,192.0,5,5,0,0,0,0,0,0
2437,32872,1047891,100,1,1913,1,male,694.0,45,28,5,1,5,1,0,0
2438,93570,1264782,19,12,1994,10,male,667.0,682,395,121,256,121,173,0,83
2439,84494,1575545,57,23,1956,12,male,1699.0,322,231,23,207,0,54,23,153
2440,28322,1145959,16,11,1997,9,female,431.0,38,24,0,0,0,0,0,0
2441,1387,2132812,43,30,1970,5,male,341.0,0,0,0,0,0,0,0,0
2442,72451,1037881,24,26,1989,10,male,491.0,194,146,4,5,4,4,0,1
2443,83750,1534831,22,19,1991,8,male,201.0,310,225,124,63,124,23,0,40
2444,9773,2150789,34,11,1979,1,female,8.0,10,9,0,0,0,0,0,0
2445,23792,1871682,20,20,1993,3,male,291.0,29,16,4,12,0,4,4,8
2446,47834,1461566,52,2,1961,9,female,182.0,78,55,9,11,0,3,9,8
2447,33646,1738008,63,22,1950,8,male,433.0,47,44,0,5,0,2,0,3
2448,95908,1142302,30,21,1983,11,male,403.0,874,691,1482,115,1482,98,0,17
2449,63726,2114059,15,8,1998,1,female,412.0,139,61,20,64,7,36,13,28
2450,47811,1484415,23,15,1990,5,male,199.0,77,71,7,19,6,11,1,8
2451,65876,1388632,15,10,1998,10,female,477.0,147,120,62,108,62,88,0,20
2452,25108,1351070,51,6,1962,4,female,1050.0,31,20,145,78,0,15,145,63
2453,60861,1606383,64,20,1949,1,female,1026.0,124,91,58,15,0,12,58,3
2454,65066,1434885,20,14,1993,4,female,562.0,140,103,506,734,128,450,378,284
2455,96838,1719307,19,21,1994,9,female,277.0,1085,951,1268,672,1232,303,36,369
2456,23618,1017119,29,9,1984,8,male,201.0,29,28,1,1,1,1,0,0
2457,98397,1733618,17,20,1996,11,female,540.0,1955,987,249,54,229,25,20,29
2458,71474,2185628,14,17,1999,4,male,324.0,188,89,9,2,0,0,9,2
2459,70018,2065366,22,13,1991,7,female,143.0,174,117,289,597,12,44,277,553
2460,54464,1196284,40,22,1973,5,male,475.0,99,76,0,4,0,3,0,1
2461,60398,1454402,54,23,1959,9,male,1275.0,123,55,0,0,0,0,0,0
2462,97532,1569446,27,1,1986,1,female,1540.0,1770,888,318,834,274,597,44,237
2463,82669,1756486,19,24,1994,12,male,1112.0,294,196,62,49,20,38,42,11
2464,47930,1543212,45,30,1968,8,male,377.0,77,51,21,3,21,1,0,2
2465,92502,2011466,18,29,1995,9,male,124.0,611,486,82,37,14,26,68,11
2466,85750,2094109,17,16,1996,6,male,527.0,341,149,121,59,1,22,120,37
2467,40945,1085611,20,15,1993,8,male,37.0,61,54,230,239,90,85,140,154
2468,52412,2062499,40,19,1973,10,male,143.0,92,77,1,43,0,7,1,36
2469,53711,1939822,26,8,1987,2,male,492.0,97,54,13,11,3,5,10,6
2470,74521,1313337,25,9,1988,11,male,420.0,208,173,16,16,14,12,2,4
2471,69294,1143682,24,13,1989,3,male,513.0,175,97,0,7,0,7,0,0
2472,1886,1634817,30,1,1983,4,male,9.0,0,0,6,1,6,1,0,0
2473,57262,2091985,36,16,1977,3,male,625.0,108,54,0,2,0,2,0,0
2474,49769,1647485,18,14,1995,5,male,283.0,83,41,11,1,11,1,0,0
2475,20270,1749666,36,19,1977,6,male,28.0,24,18,11,7,11,5,0,2
2476,75576,1685187,100,21,1913,10,male,1211.0,218,113,21,19,21,13,0,6
2477,87204,1387999,68,30,1945,9,female,634.0,386,232,1,2,0,0,1,2
2478,37162,1196031,57,17,1956,11,male,461.0,53,14,40,124,35,65,5,59
2479,18260,1891750,43,13,1970,3,male,200.0,21,14,37,19,37,12,0,7
2480,48361,1469704,36,7,1977,10,male,1523.0,80,43,0,1,0,1,0,0
2481,19820,1513252,23,10,1990,10,male,78.0,24,24,0,1,0,1,0,0
2482,72905,1908484,20,15,1993,10,female,695.0,191,65,155,16,155,14,0,2
2483,96121,1378862,26,26,1987,8,female,744.0,1141,109,4,0,4,0,0,0
2484,46240,1564012,43,6,1970,10,female,1626.0,72,50,574,483,570,168,4,315
2485,14569,1216957,43,29,1970,1,male,1562.0,16,6,0,0,0,0,0,0
2486,44523,1956036,20,5,1993,5,male,144.0,70,47,3,7,3,3,0,4
2487,18247,1084735,61,22,1952,8,female,171.0,21,13,31,44,31,7,0,37
2488,72350,2132805,23,17,1990,4,female,771.0,195,38,1,7,1,6,0,1
2489,35150,2015936,36,31,1977,3,female,524.0,49,17,33,29,21,15,12,14
2490,97977,1801536,17,14,1996,10,female,270.0,1340,1021,4915,2496,3984,1076,931,1420
2491,3636,1541922,21,27,1992,9,male,186.0,1,1,18,9,16,9,2,0
2492,65653,1627434,21,8,1992,12,male,207.0,150,147,17,11,0,10,17,1
2493,73983,1945674,41,28,1972,6,female,558.0,199,112,422,541,328,389,94,152
2494,32657,1972477,49,12,1964,1,male,1551.0,45,17,1,1,0,1,1,0
2495,96689,1040445,19,5,1994,12,female,661.0,1134,295,547,2792,204,1581,343,1211
2496,69565,1485152,25,11,1988,11,male,754.0,171,155,10,14,10,3,0,11
2497,47057,1828423,30,2,1983,7,male,205.0,75,56,30,31,30,14,0,17
2498,48250,1936291,16,13,1997,9,female,398.0,80,41,0,0,0,0,0,0
2499,49518,1007498,28,25,1985,10,female,116.0,83,27,1,1,1,0,0,1
2500,74211,1383239,89,5,1924,8,female,1568.0,205,109,0,13,0,8,0,5
2501,11357,1584356,33,6,1980,6,male,497.0,11,11,10,3,10,2,0,1
2502,92537,2092166,15,6,1998,1,female,340.0,634,127,98,73,98,54,0,19
2503,50644,2037375,17,7,1996,11,male,33.0,86,83,4,1,3,1,1,0
2504,63860,1382540,90,24,1923,8,female,1069.0,136,55,49,39,46,17,3,22
2505,89320,1747324,29,3,1984,5,male,1514.0,458,237,6,20,6,16,0,4
2506,58168,2140319,32,19,1981,9,female,622.0,108,94,1040,727,1040,646,0,81
2507,23160,1641094,18,9,1995,8,male,394.0,29,27,0,0,0,0,0,0
2508,63581,1187600,27,24,1986,10,male,220.0,137,90,7,1,7,1,0,0
2509,92431,1036253,21,20,1992,2,male,172.0,574,253,46,14,10,4,36,10
2510,20600,1507857,29,14,1984,4,male,898.0,25,23,0,1,0,1,0,0
2511,94176,1178929,19,30,1994,10,male,545.0,734,580,4,15,4,12,0,3
2512,71409,1197765,26,4,1987,12,male,216.0,189,46,4,53,4,16,0,37
2513,16393,1626915,23,15,1990,3,female,925.0,19,13,0,1,0,0,0,1
2514,63050,1675190,33,31,1980,1,male,403.0,131,97,175,247,175,220,0,27
2515,20153,2129711,82,10,1931,1,female,1192.0,24,8,5,0,0,0,5,0
2516,79221,1921871,20,15,1993,6,female,601.0,251,107,1,0,1,0,0,0
2517,10097,2023489,30,17,1983,2,male,174.0,9,8,1,2,0,2,1,0
2518,81667,1645019,103,1,1910,1,female,616.0,277,133,69,33,69,29,0,4
2519,22081,2167447,79,14,1934,8,female,13.0,26,17,14,14,0,1,14,13
2520,80576,1005203,58,7,1955,9,female,2052.0,262,146,27,33,26,8,1,25
2521,61689,1561776,36,1,1977,1,female,69.0,125,104,24,59,16,48,8,11
2522,68683,1922092,30,29,1983,10,male,455.0,163,119,21,25,21,25,0,0
2523,45075,1211969,14,2,1999,1,male,494.0,71,56,0,1,0,0,0,1
2524,95124,1792838,57,12,1956,9,male,1571.0,862,230,3,0,3,0,0,0
2525,48587,1535529,17,14,1996,12,male,312.0,80,69,4,13,4,13,0,0
2526,64810,1776441,36,9,1977,10,male,174.0,144,77,48,70,48,44,0,26
2527,6637,2113814,25,16,1988,9,male,13.0,5,5,0,0,0,0,0,0
2528,87890,1972272,49,31,1964,10,female,197.0,398,291,366,190,16,63,350,127
2529,30309,1634765,60,8,1953,3,male,139.0,40,15,0,23,0,1,0,22
2530,43559,1107192,108,19,1905,12,female,1568.0,67,38,0,0,0,0,0,0
2531,12072,1979816,27,26,1986,4,female,274.0,12,10,23,34,12,11,11,23
2532,13889,1989526,51,29,1962,3,female,351.0,15,4,2,0,0,0,2,0
2533,79550,1262794,103,9,1910,12,male,1188.0,260,186,27,101,27,60,0,41
2534,5712,1046194,41,5,1972,6,male,10.0,3,3,41,2,41,2,0,0
2535,24886,1143309,52,6,1961,10,female,152.0,31,25,9,14,9,8,0,6
2536,98989,1008872,25,5,1988,9,female,273.0,2332,1849,6135,4952,6029,4547,106,405
2537,19637,1592279,41,3,1972,8,male,626.0,23,11,94,2,94,2,0,0
2538,24298,2118837,71,11,1942,3,female,354.0,29,13,56,30,44,22,12,8
2539,24996,1481190,67,27,1946,12,male,1461.0,31,18,29,1,29,1,0,0
2540,77703,1141402,63,15,1950,4,male,1016.0,235,186,52,53,22,38,30,15
2541,3152,1693280,25,2,1988,1,male,340.0,1,1,1,0,0,0,1,0
2542,89480,1776582,18,14,1995,8,female,176.0,459,114,34,136,34,98,0,38
2543,11148,1299304,25,1,1988,1,female,262.0,11,5,1,0,1,0,0,0
2544,72060,1622422,67,8,1946,2,female,1756.0,183,122,482,324,348,169,134,155
2545,16209,2108259,25,1,1988,1,female,265.0,18,16,53,21,53,21,0,0
2546,11747,1777786,57,19,1956,9,male,313.0,12,9,0,0,0,0,0,0
2547,20721,1042380,51,1,1962,10,male,1011.0,25,19,1,1,0,0,1,1
2548,31422,1509858,38,2,1975,1,female,20.0,42,35,0,0,0,0,0,0
2549,60234,1981711,27,5,1986,3,male,127.0,120,85,721,410,721,222,0,188
2550,43211,2030040,57,13,1956,6,female,1651.0,65,30,84,31,84,24,0,7
2551,63866,1523093,14,14,1999,1,male,162.0,138,114,51,5,44,0,7,5
2552,61747,1682930,17,25,1996,10,male,274.0,127,117,33,4,33,4,0,0
2553,15538,1025578,28,1,1985,3,female,398.0,16,14,216,65,216,57,0,8
2554,96999,1267229,24,14,1989,9,female,484.0,1171,695,14799,22513,12934,17955,1865,4558
2555,49817,1714938,19,8,1994,5,male,253.0,82,57,15,43,15,32,0,11
2556,46985,2179331,108,22,1905,9,female,1398.0,74,37,21,8,16,1,5,7
2557,16420,1278444,25,1,1988,1,male,39.0,19,18,0,0,0,0,0,0
2558,91308,1894476,20,11,1993,7,male,869.0,541,384,14,77,14,32,0,45
2559,53801,1025123,28,1,1985,1,male,775.0,96,23,21,2,14,0,7,2
2560,66396,1074828,26,1,1987,1,male,557.0,156,102,1,0,1,0,0,0
2561,94980,1571469,18,11,1995,6,female,287.0,763,389,1936,2643,261,981,1675,1662
2562,86296,1371274,18,4,1995,10,female,388.0,371,116,4,7,4,7,0,0
2563,21854,1507480,20,10,1993,2,male,531.0,26,10,4,1,4,0,0,1
2564,32283,1710903,58,25,1955,6,male,733.0,42,40,139,208,0,61,139,147
2565,40216,1439118,33,26,1980,11,male,443.0,60,53,0,0,0,0,0,0
2566,46335,2050858,19,6,1994,4,male,425.0,74,22,0,10,0,10,0,0
2567,85690,1435283,71,26,1942,6,female,1481.0,339,203,86,303,0,56,86,247
2568,15932,1886818,38,11,1975,6,male,255.0,18,13,2,0,2,0,0,0
2569,11229,1312241,22,26,1991,5,female,938.0,11,9,3,0,0,0,3,0
2570,41767,1226728,14,6,1999,2,male,291.0,63,41,11,1,0,1,11,0
2571,47922,1180995,16,1,1997,8,female,11.0,77,46,20,168,14,139,6,29
2572,88736,1882845,22,6,1991,9,female,333.0,425,286,148,31,0,10,148,21
2573,13430,1497726,41,6,1972,3,female,4.0,13,13,48,37,48,18,0,19
2574,56873,1757581,72,20,1941,1,male,432.0,106,69,46,88,31,37,15,51
2575,42808,1815664,28,5,1985,3,female,148.0,66,44,4,7,4,5,0,2
2576,61531,2093276,19,26,1994,3,male,444.0,128,83,7,0,0,0,7,0
2577,8204,1232665,24,25,1989,10,male,357.0,6,4,3,1,0,0,3,1
2578,39948,2071857,83,28,1930,3,female,1729.0,58,29,80,39,80,32,0,7
2579,40886,1115034,77,5,1936,9,female,1157.0,61,23,128,18,122,8,6,10
2580,96222,1691903,108,11,1905,7,male,1501.0,1039,525,20,257,2,53,18,204
2581,81299,2094223,62,26,1951,9,male,1282.0,283,188,4,11,0,7,4,4
2582,14067,1497874,35,17,1978,1,male,209.0,15,15,11,0,0,0,11,0
2583,51621,1664550,28,3,1985,11,female,209.0,90,76,5,5,5,3,0,2
2584,31071,2189090,31,1,1982,1,male,75.0,40,22,73,2,72,2,1,0
2585,50498,2072513,13,26,2000,7,male,33.0,85,76,1,0,1,0,0,0
2586,75178,1210115,23,1,1990,1,female,583.0,217,179,0,0,0,0,0,0
2587,78318,1292297,17,10,1996,10,male,297.0,241,203,2,4,0,0,2,4
2588,41286,2102323,55,29,1958,6,male,138.0,64,36,0,0,0,0,0,0
2589,5839,1193591,20,18,1993,2,male,23.0,4,4,0,0,0,0,0,0
2590,76115,1254942,108,22,1905,9,male,160.0,217,145,879,15,842,6,37,9
2591,62410,1311799,34,9,1979,1,male,978.0,130,69,1,2,1,2,0,0
2592,25951,1645491,66,6,1947,5,male,46.0,33,17,11,0,11,0,0,0
2593,16534,1305694,37,4,1976,5,female,532.0,20,13,0,3,0,3,0,0
2594,35764,1560719,60,16,1953,11,female,549.0,51,44,2,6,0,3,2,3
2595,79453,1116909,21,30,1992,4,male,645.0,261,197,14,0,14,0,0,0
2596,94596,2159962,19,23,1994,8,female,857.0,809,305,178,431,129,264,49,167
2597,83044,1038069,18,10,1995,11,female,337.0,299,211,736,631,500,511,236,120
2598,29988,1273323,69,15,1944,3,male,1152.0,39,19,79,85,0,41,79,44
2599,4029,1697011,26,1,1987,1,male,500.0,2,2,0,0,0,0,0,0
2600,79964,1522451,107,6,1906,2,male,1417.0,253,192,423,346,423,286,0,60
2601,9421,2088782,15,21,1998,1,male,384.0,9,3,0,0,0,0,0,0
2602,9991,2175173,59,15,1954,8,male,1003.0,9,6,0,0,0,0,0,0
2603,66071,1853363,53,20,1960,6,female,1097.0,145,49,223,95,210,78,13,17
2604,18715,1222072,61,10,1952,5,male,627.0,23,12,0,1,0,1,0,0
2605,58464,1773113,29,18,1984,8,female,303.0,113,59,3,0,3,0,0,0
2606,74202,1434604,37,15,1976,3,male,876.0,206,170,0,0,0,0,0,0
2607,77643,1687006,26,14,1987,2,female,364.0,233,162,36,30,36,29,0,1
2608,77028,1427216,23,13,1990,11,male,458.0,223,133,474,70,228,23,246,47
2609,8438,1991137,25,5,1988,4,male,1123.0,6,4,10,4,10,4,0,0
2610,60075,1753692,47,17,1966,5,female,302.0,120,44,159,145,159,92,0,53
2611,3135,1029865,17,28,1996,10,female,416.0,1,1,1,0,0,0,1,0
2612,37137,1281412,29,8,1984,11,female,403.0,53,26,34,2,34,2,0,0
2613,76892,1196254,14,7,1999,8,female,157.0,223,141,154,246,154,74,0,172
2614,8701,1700768,15,1,1998,11,male,3.0,8,5,0,0,0,0,0,0
2615,48557,2105908,13,3,2000,4,female,210.0,80,61,3,7,3,4,0,3
2616,63145,1474629,14,13,1999,11,female,153.0,132,82,413,444,413,325,0,119
2617,85727,1643974,103,14,1910,7,male,575.0,338,281,100,34,100,34,0,0
2618,46362,1765307,23,20,1990,12,female,586.0,76,26,0,11,0,7,0,4
2619,66866,2075137,44,16,1969,7,female,598.0,155,70,60,119,44,75,16,44
2620,49047,1888682,18,1,1995,3,male,472.0,79,51,83,34,83,25,0,9
2621,29475,1532937,15,5,1998,4,male,233.0,39,30,0,0,0,0,0,0
2622,9373,1964827,68,9,1945,12,male,751.0,8,5,101,17,0,0,101,17
2623,30702,1428051,53,12,1960,2,male,1489.0,41,21,8,1,2,0,6,1
2624,90687,1284874,26,12,1987,10,male,270.0,511,94,150,576,65,433,85,143
2625,94713,1649663,66,28,1947,6,male,427.0,741,555,312,562,270,386,42,176
2626,35508,2169035,20,20,1993,4,female,409.0,51,34,0,0,0,0,0,0
2627,14754,1589099,21,22,1992,5,male,20.0,17,15,1,0,1,0,0,0
2628,28784,1551231,32,5,1981,5,male,731.0,38,31,3,4,0,0,3,4
2629,91913,1114387,15,22,1998,10,female,562.0,557,493,743,216,720,174,23,42
2630,63487,1554173,16,24,1997,8,male,501.0,139,102,3,4,0,0,3,4
2631,4228,2022976,37,26,1976,5,female,264.0,2,1,0,0,0,0,0,0
2632,11154,1023989,27,25,1986,1,male,87.0,11,7,1,0,1,0,0,0
2633,66249,1361853,14,14,1999,7,male,128.0,153,122,0,0,0,0,0,0
2634,44114,1096768,69,16,1944,6,female,1129.0,68,46,121,141,121,86,0,55
2635,51985,1353558,31,20,1982,3,female,818.0,90,44,59,47,57,26,2,21
2636,62510,1304894,33,7,1980,6,female,334.0,133,61,4,1,4,1,0,0
2637,40973,1446446,42,1,1971,1,female,779.0,61,32,323,100,192,71,131,29
2638,54190,2188251,37,22,1976,11,male,300.0,96,78,190,12,190,11,0,1
2639,29217,1712080,17,13,1996,8,female,174.0,37,18,38,7,38,3,0,4
2640,60113,1406632,27,7,1986,9,male,358.0,118,71,208,58,0,3,208,55
2641,77363,1063548,21,13,1992,9,male,320.0,236,145,4,0,0,0,4,0
2642,7659,2137727,33,1,1980,2,male,806.0,6,6,0,0,0,0,0,0
2643,36620,1194653,46,27,1967,4,female,598.0,53,22,0,4,0,3,0,1
2644,41607,2131062,24,12,1989,3,male,75.0,62,52,4,8,4,8,0,0
2645,20149,1368076,71,6,1942,4,male,1253.0,24,18,4,5,4,4,0,1
2646,3849,1584595,18,29,1995,5,female,571.0,2,1,0,0,0,0,0,0
2647,41509,2068824,43,13,1970,5,male,446.0,64,23,2,3,2,3,0,0
2648,42682,1683887,18,2,1995,6,male,475.0,65,49,1,39,1,34,0,5
2649,57558,1087634,61,8,1952,4,female,1755.0,108,71,7,20,0,17,7,3
2650,20154,2074023,58,25,1955,3,male,575.0,24,17,5,2,0,1,5,1
2651,93442,1246913,29,4,1984,8,female,468.0,694,284,57,161,57,140,0,21
2652,12850,1703653,37,1,1976,1,male,322.0,13,11,2,1,0,0,2,1
2653,15834,2070072,108,22,1905,8,female,181.0,18,15,0,0,0,0,0,0
2654,8325,1891040,39,18,1974,11,male,269.0,7,5,5,0,5,0,0,0
2655,42589,1877820,40,28,1973,4,male,549.0,66,44,0,0,0,0,0,0
2656,43225,1857966,55,5,1958,3,female,1171.0,65,43,92,7,0,2,92,5
2657,7307,2051489,14,22,1999,2,male,204.0,6,6,0,0,0,0,0,0
2658,82132,1339104,19,23,1994,11,male,654.0,299,244,0,2,0,2,0,0
2659,2153,1765445,21,23,1992,11,male,177.0,1,1,0,0,0,0,0,0
2660,86245,1455393,101,30,1912,1,male,1034.0,361,260,2,1,0,0,2,1
2661,95681,1482349,18,13,1995,3,female,915.0,994,528,419,597,362,313,57,284
2662,21010,2173012,25,1,1988,1,male,167.0,25,22,28,6,28,2,0,4
2663,62745,1800163,38,2,1975,5,male,248.0,132,41,24,42,24,34,0,8
2664,23195,1118510,21,1,1992,1,male,145.0,30,21,0,1,0,0,0,1
2665,55388,1753968,46,20,1967,8,male,389.0,101,66,0,3,0,2,0,1
2666,74630,1554130,106,15,1907,7,female,1025.0,208,68,32,13,32,1,0,12
2667,69375,1460373,22,1,1991,7,male,708.0,172,98,1,3,1,0,0,3
2668,90982,1822956,20,8,1993,1,female,186.0,495,430,1236,310,1003,220,233,90
2669,1173,1073170,35,1,1978,1,male,7.0,0,0,0,0,0,0,0,0
2670,86605,1078980,23,12,1990,12,male,794.0,379,284,62,3,43,2,19,1
2671,71326,1655467,27,19,1986,6,male,633.0,186,167,2,1,0,0,2,1
2672,14179,1457358,41,3,1972,12,male,103.0,15,13,44,32,44,31,0,1
2673,34247,1669035,27,20,1986,6,female,361.0,47,27,57,10,57,10,0,0
2674,20087,1493940,67,8,1946,4,male,946.0,24,17,2,10,2,10,0,0
2675,23020,1604088,49,5,1964,9,male,81.0,28,15,51,43,5,20,46,23
2676,87973,1491970,20,14,1993,3,female,459.0,384,179,612,1194,608,987,4,207
2677,3043,1035840,53,14,1960,5,male,403.0,1,1,0,0,0,0,0,0
2678,17452,2162629,67,29,1946,11,female,510.0,20,8,35,77,3,42,32,35
2679,65755,1444186,28,28,1985,10,male,313.0,150,75,32,25,21,18,11,7
2680,55487,1439591,27,5,1986,3,male,211.0,103,67,2,0,0,0,2,0
2681,20789,1087997,25,28,1988,6,male,215.0,25,24,2,0,2,0,0,0
2682,90301,1622890,25,22,1988,10,male,486.0,502,404,10,9,10,9,0,0
2683,9153,1175429,52,5,1961,5,male,38.0,8,6,3,1,3,1,0,0
2684,10321,1711382,73,4,1940,5,female,164.0,10,10,2,9,2,0,0,9
2685,43625,1353371,48,17,1965,2,male,1119.0,67,19,1,8,1,6,0,2
2686,79832,1293881,57,29,1956,3,female,1406.0,251,225,160,82,67,48,93,34
2687,47929,1081341,19,30,1994,9,male,235.0,77,62,21,1,21,1,0,0
2688,65126,1750998,46,24,1967,8,female,1420.0,142,74,1560,795,521,131,1039,664
2689,2037,1624566,16,14,1997,9,female,84.0,1,1,0,0,0,0,0,0
2690,22105,2105542,59,13,1954,12,male,1088.0,26,6,16,55,0,45,16,10
2691,4773,2021362,27,19,1986,4,male,288.0,2,2,13,6,13,6,0,0
2692,96577,1369346,19,8,1994,10,female,1530.0,1097,401,312,742,130,272,182,470
2693,95343,1713136,106,9,1907,6,female,822.0,838,284,59,60,59,45,0,15
2694,40959,2008848,21,19,1992,7,female,333.0,61,23,251,5,251,2,0,3
2695,29061,1191310,19,24,1994,12,male,243.0,37,28,15,1,15,1,0,0
2696,98010,1875104,18,25,1995,10,female,785.0,4210,156,0,39,0,32,0,7
2697,23249,1044417,25,15,1988,5,male,434.0,29,16,0,1,0,1,0,0
2698,80569,2036213,28,15,1985,7,male,165.0,267,138,26,8,26,5,0,3
2699,85480,2041671,17,6,1996,5,male,229.0,342,85,23,9,23,5,0,4
2700,89049,2033738,38,1,1975,8,female,2373.0,432,312,1217,889,473,352,744,537
2701,30705,1340536,14,6,1999,7,male,0.0,41,40,8,0,8,0,0,0
2702,36340,2113339,17,21,1996,3,female,467.0,51,27,152,48,150,6,2,42
2703,60045,1382615,14,26,1999,9,male,371.0,120,89,133,7,98,6,35,1
2704,23797,1960830,25,2,1988,8,male,345.0,30,29,4,0,4,0,0,0
2705,29369,1313770,45,22,1968,5,male,324.0,37,34,139,65,0,47,139,18
2706,66770,1832632,35,20,1978,4,male,294.0,154,117,33,11,0,2,33,9
2707,49631,1241524,34,6,1979,6,male,1187.0,82,37,3,12,3,1,0,11
2708,74749,1373127,17,31,1996,7,female,158.0,211,171,69,10,42,2,27,8
2709,38171,1703449,25,5,1988,5,male,30.0,55,38,80,32,80,28,0,4
2710,38596,2037887,19,13,1994,5,male,327.0,57,17,2,1,2,1,0,0
2711,60131,1721140,63,17,1950,1,female,1533.0,119,19,235,138,0,18,235,120
2712,50334,1506199,20,31,1993,5,male,164.0,87,73,0,0,0,0,0,0
2713,85631,1367447,18,14,1995,12,male,478.0,342,152,62,66,7,35,55,31
2714,32648,1527137,104,1,1909,1,male,46.0,45,35,0,1,0,1,0,0
2715,96556,2023304,17,2,1996,3,female,539.0,1234,158,287,199,22,60,265,139
2716,91596,1544588,24,28,1989,9,male,393.0,549,494,122,282,122,268,0,14
2717,92891,1151722,18,15,1995,4,female,894.0,584,337,635,676,525,217,110,459
2718,78923,1352000,18,23,1995,7,male,452.0,244,165,283,126,283,120,0,6
2719,95765,1260308,22,24,1991,2,female,1841.0,993,375,635,865,593,399,42,466
2720,57902,1538581,47,9,1966,8,male,1269.0,111,36,69,16,25,15,44,1
2721,49046,1514081,17,8,1996,6,female,248.0,81,49,83,15,83,14,0,1
2722,59951,1769716,33,15,1980,8,male,343.0,119,86,66,32,5,19,61,13
2723,45124,1162646,20,9,1993,2,male,342.0,71,60,0,0,0,0,0,0
2724,14198,1210405,21,2,1992,12,female,1091.0,15,8,76,25,19,4,57,21
2725,689,2098066,25,21,1988,4,male,20.0,0,0,0,0,0,0,0,0
2726,20358,1822495,54,22,1959,3,female,253.0,24,15,29,66,27,48,2,18
2727,39149,1595718,56,4,1957,11,female,1384.0,57,18,237,258,228,143,9,115
2728,23893,2047902,61,4,1952,6,female,681.0,30,26,7,3,6,1,1,2
2729,33141,1539941,24,12,1989,9,male,119.0,45,39,32,1,32,1,0,0
2730,10911,1060551,24,6,1989,6,male,367.0,11,1,0,0,0,0,0,0
2731,57026,1384950,15,17,1998,6,male,87.0,105,79,181,150,85,39,96,111
2732,63340,1892415,31,22,1982,6,male,460.0,137,133,0,0,0,0,0,0
2733,27270,1499582,25,1,1988,1,male,46.0,34,32,12,5,12,3,0,2
2734,92420,1786432,108,22,1905,5,male,947.0,586,421,42,89,42,57,0,32
2735,18281,2159510,37,29,1976,11,female,504.0,21,15,49,16,49,12,0,4
2736,64157,1750042,18,10,1995,12,female,610.0,139,64,605,1072,221,208,384,864
2737,51890,1812604,16,3,1997,2,male,225.0,89,48,35,0,3,0,32,0
2738,5440,1881289,29,7,1984,3,male,560.0,3,3,1,0,1,0,0,0
2739,83503,1523189,16,18,1997,2,male,217.0,316,253,24,34,24,18,0,16
2740,56764,1876876,22,11,1991,10,male,117.0,107,106,20,11,20,2,0,9
2741,29626,1800369,63,7,1950,9,male,942.0,39,19,0,1,0,1,0,0
2742,79462,2079345,24,7,1989,5,female,375.0,255,187,15,22,0,9,15,13
2743,51992,1278756,19,23,1994,5,male,232.0,89,65,65,14,59,7,6,7
2744,19097,2084432,49,23,1964,7,female,596.0,23,17,4,0,4,0,0,0
2745,61407,1936692,21,16,1992,6,female,706.0,125,83,2,9,2,7,0,2
2746,67097,1763989,53,12,1960,9,male,408.0,153,97,235,238,223,116,12,122
2747,16827,1977729,17,13,1996,8,female,20.0,19,7,1,7,1,6,0,1
2748,79542,1785332,20,12,1993,2,male,317.0,259,88,27,28,0,9,27,19
2749,81747,1767759,25,24,1988,7,female,766.0,281,116,109,44,97,29,12,15
2750,41497,1774167,18,24,1995,12,male,73.0,63,52,2,26,2,21,0,5
2751,86417,1152360,28,1,1985,1,male,573.0,368,346,15,8,0,5,15,3
2752,6707,1079406,31,20,1982,8,male,329.0,5,5,0,0,0,0,0,0
2753,88899,1153649,23,12,1990,1,female,792.0,421,363,348,392,72,144,276,248
2754,12852,1786130,53,19,1960,2,female,614.0,13,8,2,1,0,1,2,0
2755,49576,1659580,18,3,1995,3,male,22.0,83,83,2,2,2,2,0,0
2756,53900,1037139,44,18,1969,1,male,61.0,94,31,33,133,24,35,9,98
2757,51641,1000756,14,4,1999,5,female,390.0,90,42,6,2,6,2,0,0
2758,70067,1123686,103,3,1910,12,female,901.0,172,111,449,280,449,184,0,96
2759,13644,1902303,25,1,1988,1,male,65.0,15,12,0,0,0,0,0,0
2760,57125,1794218,15,7,1998,4,male,35.0,107,74,677,89,643,52,34,37
2761,77273,1582391,103,26,1910,1,male,1460.0,237,83,1,0,1,0,0,0
2762,2455,1465059,26,1,1987,1,male,377.0,1,1,0,0,0,0,0,0
2763,50680,1986891,21,18,1992,9,male,528.0,85,41,6,1,0,1,6,0
2764,24847,2161729,71,13,1942,2,male,1486.0,31,13,6,0,6,0,0,0
2765,3465,1151771,33,20,1980,7,male,430.0,1,1,4,1,4,1,0,0
2766,40570,1005283,43,16,1970,1,male,944.0,61,7,11,12,11,6,0,6
2767,65600,1318745,20,3,1993,4,male,1175.0,145,51,12,10,0,4,12,6
2768,20001,1693321,25,13,1988,6,female,374.0,24,19,1,0,1,0,0,0
2769,58048,1257499,21,23,1992,1,female,256.0,108,50,189,7,1,3,188,4
2770,29871,1593285,101,26,1912,5,female,132.0,39,18,19,4,0,1,19,3
2771,95845,1578658,27,16,1986,5,female,176.0,877,598,1090,1573,197,728,893,845
2772,54803,1265272,56,24,1957,7,male,739.0,99,44,17,0,10,0,7,0
2773,65932,1630893,23,21,1990,10,female,218.0,149,62,91,38,91,34,0,4
2774,4410,1631516,57,10,1956,11,male,37.0,2,1,0,0,0,0,0,0
2775,79122,1069228,18,6,1995,2,male,630.0,260,236,0,0,0,0,0,0
2776,98008,1170092,18,1,1995,5,male,258.0,1921,1684,0,2,0,1,0,1
2777,76292,1529204,18,8,1995,6,male,713.0,229,166,1,1,1,1,0,0
2778,71260,1283299,68,17,1945,8,male,868.0,187,110,0,1,0,1,0,0
2779,20205,1651284,21,14,1992,2,female,209.0,24,17,7,31,0,19,7,12
2780,82993,1000489,18,25,1995,12,female,129.0,302,277,543,275,515,163,28,112
2781,56310,2010352,60,12,1953,12,female,425.0,103,65,1357,775,16,335,1341,440
2782,25777,1722854,39,28,1974,1,female,355.0,32,28,4,16,4,16,0,0
2783,26496,1697618,19,18,1994,2,male,322.0,34,20,0,0,0,0,0,0
2784,91752,1563857,15,2,1998,4,female,608.0,559,496,306,67,199,59,107,8
2785,46209,1396013,65,4,1948,3,female,740.0,72,47,382,107,194,54,188,53
2786,43921,1355752,106,4,1907,8,male,1132.0,67,51,30,5,0,5,30,0
2787,18869,2118643,17,8,1996,2,male,171.0,22,19,1,1,1,1,0,0
2788,36262,1823804,35,26,1978,3,female,163.0,51,41,80,11,80,10,0,1
2789,60819,1802887,15,3,1998,7,female,241.0,121,57,43,6,3,4,40,2
2790,24360,1521872,39,17,1974,2,female,77.0,29,24,90,7,0,0,90,7
2791,32515,1169338,27,27,1986,8,female,678.0,44,3,0,5,0,5,0,0
2792,88370,1297131,75,8,1938,2,male,1362.0,428,142,11,0,9,0,2,0
2793,83687,1672595,51,26,1962,12,female,2182.0,318,154,83,58,83,45,0,13
2794,85872,1373498,14,3,1999,2,female,86.0,352,150,239,116,138,46,101,70
2795,1095,1441479,33,1,1980,1,male,209.0,0,0,0,0,0,0,0,0
2796,97285,1561795,20,25,1993,3,male,663.0,1325,743,56,2,56,1,0,1
2797,76824,1626225,23,10,1990,12,female,35.0,227,50,95,135,95,102,0,33
2798,936,1844381,29,13,1984,8,male,191.0,0,0,0,0,0,0,0,0
2799,31115,1550541,21,16,1992,9,male,46.0,41,41,108,23,97,17,11,6
2800,38261,2157439,33,6,1980,4,female,29.0,55,17,196,168,196,91,0,77
2801,77642,1040900,23,6,1990,6,female,2029.0,239,159,36,39,36,19,0,20
2802,29074,1847488,47,30,1966,7,male,927.0,37,17,16,3,16,3,0,0
2803,61960,1246354,66,14,1947,8,female,1686.0,125,70,116,232,75,92,41,140
2804,8610,1378601,27,5,1986,5,female,104.0,7,6,61,41,61,19,0,22
2805,97043,1950308,27,20,1986,8,male,980.0,1329,1118,0,0,0,0,0,0
2806,67803,1972332,41,16,1972,2,male,528.0,160,101,53,14,0,6,53,8
2807,25417,2131894,56,28,1957,10,male,507.0,33,21,0,1,0,1,0,0
2808,45081,1459559,15,24,1998,4,female,235.0,72,34,0,0,0,0,0,0
2809,68903,1529082,20,4,1993,11,male,230.0,169,115,84,54,78,38,6,16
2810,47405,1184968,19,14,1994,4,female,328.0,75,42,400,271,264,108,136,163
2811,37568,1034418,59,11,1954,11,male,742.0,55,44,0,0,0,0,0,0
2812,65194,1171131,20,3,1993,3,male,594.0,149,55,0,18,0,15,0,3
2813,22042,1957712,69,9,1944,12,female,93.0,26,9,11,8,11,8,0,0
2814,4332,2102604,44,5,1969,10,male,249.0,2,2,0,0,0,0,0,0
2815,86404,1533582,19,27,1994,1,female,188.0,374,339,13,5,13,0,0,5
2816,50911,1614677,45,28,1968,10,female,699.0,86,69,31,19,0,8,31,11
2817,41331,1854699,101,17,1912,11,male,354.0,62,41,0,0,0,0,0,0
2818,59140,1199074,67,28,1946,3,female,1191.0,115,98,672,255,672,180,0,75
2819,94120,1911761,113,8,1900,10,female,1131.0,803,236,1,58,0,17,1,41
2820,19589,1406016,18,23,1995,8,male,587.0,22,21,61,72,58,15,3,57
2821,64516,1193009,16,16,1997,11,male,516.0,144,22,5,1,0,0,5,1
2822,37938,1856352,35,18,1978,10,male,525.0,54,15,17,28,17,22,0,6
2823,42025,1983408,54,21,1959,8,female,1418.0,63,38,39,17,36,13,3,4
2824,98666,1871174,20,30,1993,3,female,968.0,3071,1827,936,3038,110,1741,826,1297
2825,65918,2037678,43,14,1970,12,female,1061.0,145,46,82,74,62,41,20,33
2826,55146,1787959,91,31,1922,1,male,693.0,99,84,242,87,242,80,0,7
2827,54019,1500432,21,26,1992,6,female,253.0,95,78,65,14,0,2,65,12
2828,60508,1450376,81,15,1932,4,female,1014.0,121,50,2,37,2,37,0,0
2829,98312,1163502,36,27,1977,9,male,2258.0,2561,1711,127,1893,47,1442,80,451
2830,86280,1055920,24,4,1989,9,female,405.0,360,145,3,3,3,3,0,0
2831,11812,1323868,76,27,1937,7,female,131.0,12,10,1,3,0,0,1,3
2832,6597,1972504,22,8,1991,9,male,91.0,5,4,0,0,0,0,0,0
2833,42873,1113499,67,1,1946,1,male,1843.0,65,28,7,1,7,0,0,1
2834,81044,2106173,21,28,1992,8,female,185.0,262,117,789,1298,789,1146,0,152
2835,14857,1691142,50,31,1963,5,female,1279.0,17,8,2,3,0,3,2,0
2836,93687,2136867,72,14,1941,11,female,831.0,708,565,250,76,21,51,229,25
2837,76018,1368615,23,20,1990,10,male,383.0,217,185,265,48,265,47,0,1
2838,71318,1243652,42,1,1971,1,male,259.0,184,152,1,16,1,16,0,0
2839,9739,1962391,31,20,1982,1,male,544.0,10,1,0,0,0,0,0,0
2840,66623,1304051,56,18,1957,9,female,305.0,153,110,11,44,0,6,11,38
2841,79953,1694274,27,30,1986,8,female,450.0,254,183,417,502,151,137,266,365
2842,12452,1348822,32,11,1981,10,male,353.0,13,13,0,3,0,3,0,0
2843,17228,1171542,46,22,1967,11,female,60.0,20,7,10,5,10,5,0,0
2844,98290,1719894,17,13,1996,6,female,1104.0,4662,1391,108,2477,74,1512,34,965
2845,50930,1066910,75,9,1938,7,female,1000.0,87,62,33,71,33,41,0,30
2846,54455,1577928,33,1,1980,1,male,165.0,98,96,0,1,0,0,0,1
2847,76864,1630036,18,21,1995,8,female,681.0,227,159,126,96,125,38,1,58
2848,75760,2125984,25,5,1988,5,male,435.0,218,189,63,8,63,5,0,3
2849,78375,1516902,19,13,1994,9,female,665.0,246,102,4,0,4,0,0,0
2850,75688,2170352,31,6,1982,9,male,418.0,214,132,42,176,33,112,9,64
2851,78826,1983310,55,20,1958,2,male,1509.0,248,175,128,2497,107,1093,21,1404
2852,71960,1594516,35,3,1978,2,female,665.0,184,145,200,210,142,125,58,85
2853,31006,1664458,66,23,1947,9,female,643.0,41,20,48,28,0,25,48,3
2854,94207,2161769,103,25,1910,6,male,459.0,806,765,7,5,7,5,0,0
2855,3355,1484417,42,18,1971,8,female,498.0,1,0,2,0,2,0,0,0
2856,9347,1756645,51,24,1962,8,female,335.0,8,3,48,21,48,17,0,4
2857,28618,1984897,68,28,1945,1,male,1772.0,38,8,1,1,0,0,1,1
2858,70106,1110615,22,1,1991,5,male,390.0,172,121,619,188,503,80,116,108
2859,50267,1388335,34,10,1979,2,female,59.0,84,74,854,197,0,48,854,149
2860,28445,1221985,28,20,1985,1,male,581.0,38,14,0,9,0,6,0,3
2861,50620,2101947,15,8,1998,11,male,691.0,87,53,3,1,3,1,0,0
2862,77960,1713265,24,21,1989,9,female,261.0,233,201,245,234,221,180,24,54
2863,68465,1679472,24,24,1989,4,male,361.0,166,139,4,6,4,2,0,4
2864,12948,1738061,108,1,1905,1,male,41.0,13,0,3,113,0,4,3,109
2865,9121,1196997,25,1,1988,1,male,49.0,8,8,2,0,2,0,0,0
2866,94959,1007387,21,8,1992,10,female,842.0,752,421,1679,1252,898,492,781,760
2867,27244,1346762,22,1,1991,1,male,163.0,34,31,11,0,7,0,4,0
2868,38229,1301274,54,7,1959,3,female,311.0,55,32,140,88,140,48,0,40
2869,86455,1229808,84,16,1929,4,male,839.0,377,248,20,2,0,0,20,2
2870,72985,1715949,108,5,1905,5,male,868.0,191,87,298,57,298,53,0,4
2871,60102,1941142,77,11,1936,2,female,469.0,119,99,194,68,0,37,194,31
2872,6258,1623378,22,16,1991,6,female,269.0,4,4,1,3,1,2,0,1
2873,31736,2041350,18,11,1995,1,female,157.0,42,22,3,42,3,10,0,32
2874,72161,1167489,78,8,1935,9,female,1578.0,187,63,1679,1719,0,465,1679,1254
2875,50807,1613777,20,14,1993,6,male,377.0,86,50,16,21,16,20,0,1
2876,20235,1214711,34,21,1979,2,female,321.0,24,7,8,2,8,0,0,2
2877,97174,1850650,18,28,1995,11,female,607.0,1897,979,17,3,17,2,0,1
2878,66319,1123579,26,5,1987,2,male,588.0,156,128,0,28,0,14,0,14
2879,35868,1362018,17,30,1996,8,male,559.0,51,41,5,3,5,2,0,1
2880,11595,1120341,23,9,1990,4,female,503.0,12,0,0,0,0,0,0,0
2881,90827,2018350,19,1,1994,1,female,599.0,490,304,338,306,331,112,7,194
2882,55841,1650684,25,15,1988,6,male,626.0,102,76,23,31,23,10,0,21
2883,29484,1467639,17,17,1996,5,female,110.0,39,26,0,0,0,0,0,0
2884,68606,1962747,40,8,1973,5,male,565.0,164,121,13,5,2,3,11,2
2885,13482,2030932,40,25,1973,11,male,135.0,13,9,81,41,81,32,0,9
2886,28077,1775099,60,12,1953,11,female,265.0,36,15,16,4,16,4,0,0
2887,86125,1090717,15,3,1998,3,female,198.0,378,39,0,1,0,1,0,0
2888,38940,1209824,51,25,1962,4,male,22.0,57,14,40,92,20,48,20,44
2889,52250,1699816,16,17,1997,12,female,146.0,93,48,0,0,0,0,0,0
2890,95727,1171687,87,26,1926,6,male,1468.0,846,312,523,274,255,111,268,163
2891,32066,1870872,16,4,1997,7,male,153.0,43,35,27,0,27,0,0,0
2892,39313,1482200,28,19,1985,3,male,588.0,59,47,0,0,0,0,0,0
2893,16985,1357264,24,25,1989,6,male,85.0,19,15,3,1,3,0,0,1
2894,11429,2036543,41,11,1972,2,male,289.0,11,11,26,3,24,2,2,1
2895,39197,1687860,19,25,1994,8,female,177.0,56,38,849,1145,849,395,0,750
2896,72964,1722405,19,10,1994,6,female,419.0,193,113,258,174,55,40,203,134
2897,44172,1183365,22,10,1991,11,female,402.0,68,54,259,263,249,78,10,185
2898,12380,1701229,26,17,1987,8,male,364.0,14,14,0,3,0,1,0,2
2899,86016,1454790,20,28,1993,9,female,265.0,344,175,702,448,685,299,17,149
2900,67257,1985676,17,24,1996,9,female,480.0,161,69,0,1,0,1,0,0
2901,3863,1993223,20,21,1993,11,female,434.0,2,1,0,0,0,0,0,0
2902,43175,2184106,66,14,1947,4,male,60.0,66,42,63,16,63,13,0,3
2903,84806,1935330,23,30,1990,6,female,238.0,330,220,181,207,181,130,0,77
2904,4476,1476013,24,2,1989,2,female,19.0,2,2,1,0,0,0,1,0
2905,35544,1127944,25,20,1988,2,male,15.0,51,45,0,0,0,0,0,0
2906,36710,1057129,26,3,1987,12,male,252.0,53,51,1,0,1,0,0,0
2907,44350,2169763,36,30,1977,7,male,392.0,69,55,0,7,0,5,0,2
2908,59654,1102831,25,19,1988,5,male,586.0,116,61,9,8,9,4,0,4
2909,57814,1111516,22,18,1991,11,male,151.0,110,77,42,25,31,19,11,6
2910,38386,2095950,21,28,1992,6,female,284.0,56,20,0,0,0,0,0,0
2911,84851,1123046,26,25,1987,6,female,1672.0,334,197,244,528,217,246,27,282
2912,15864,1671513,17,6,1996,12,male,136.0,18,14,1,0,1,0,0,0
2913,30943,1723340,14,7,1999,8,male,264.0,40,4,32,4,32,2,0,2
2914,58418,2186978,18,9,1995,5,female,139.0,112,9,2,0,2,0,0,0
2915,28782,1247437,52,2,1961,11,male,113.0,38,29,3,1,0,0,3,1
2916,20503,1077717,16,9,1997,7,male,272.0,25,15,0,1,0,1,0,0
2917,70297,1314881,23,23,1990,10,male,692.0,181,111,1,80,0,47,1,33
2918,58083,1656547,46,1,1967,6,female,126.0,109,94,304,85,0,35,304,50
2919,38288,1218688,15,15,1998,2,female,195.0,54,46,287,89,251,82,36,7
2920,14250,1461278,14,21,1999,2,male,296.0,16,9,0,0,0,0,0,0
2921,3743,1653316,20,23,1993,6,female,347.0,1,1,102,5,78,3,24,2
2922,2978,1612332,48,16,1965,2,male,731.0,1,1,0,0,0,0,0,0
2923,5897,1680250,24,1,1989,1,male,75.0,4,3,0,0,0,0,0,0
2924,27231,1056633,66,17,1947,1,male,1639.0,35,11,10,5,8,2,2,3
2925,83990,1849892,27,16,1986,7,female,1747.0,310,153,495,492,78,358,417,134
2926,16676,1219836,65,12,1948,4,male,64.0,20,16,0,0,0,0,0,0
2927,62011,1962978,27,5,1986,11,male,558.0,126,92,151,104,151,76,0,28
2928,69351,1121925,57,26,1956,10,male,299.0,170,14,1,3,0,0,1,3
2929,34978,1582443,31,1,1982,9,male,483.0,48,19,10,27,6,15,4,12
2930,53364,2031038,69,3,1944,9,male,1285.0,94,12,1,1,0,1,1,0
2931,62021,1524291,27,2,1986,11,female,134.0,126,107,171,83,171,67,0,16
2932,57840,1090615,103,3,1910,3,female,965.0,111,36,48,334,34,172,14,162
2933,21160,1270467,19,17,1994,3,female,90.0,25,14,1761,257,1761,234,0,23
2934,16249,1306290,23,25,1990,10,male,81.0,18,14,111,15,111,13,0,2
2935,90423,1850060,16,14,1997,2,male,786.0,505,50,30,249,20,160,10,89
2936,75138,2083708,18,30,1995,12,male,322.0,213,106,0,1,0,1,0,0
2937,15428,1512134,18,26,1995,2,male,265.0,16,12,67,6,4,2,63,4
2938,44352,1203718,37,23,1976,7,male,823.0,70,37,0,0,0,0,0,0
2939,77161,1445950,18,1,1995,4,female,503.0,240,220,0,0,0,0,0,0
2940,85370,2176660,28,4,1985,10,male,433.0,350,305,9,26,0,11,9,15
2941,63697,1242998,17,27,1996,9,male,958.0,136,71,16,3,3,1,13,2
2942,11201,2039853,73,13,1940,10,female,22.0,11,7,2,0,1,0,1,0
2943,116,1054620,17,31,1996,12,male,22.0,0,0,0,0,0,0,0,0
2944,54894,1397606,20,4,1993,7,female,203.0,99,44,31,5,31,4,0,1
2945,83793,1268247,30,5,1983,10,female,428.0,307,137,157,269,155,96,2,173
2946,97563,1673387,17,16,1996,8,female,547.0,1659,216,349,760,346,338,3,422
2947,90076,1658687,19,13,1994,10,female,544.0,446,256,4402,2315,4347,1324,55,991
2948,3319,1206458,51,30,1962,3,male,39.0,1,0,2,0,0,0,2,0
2949,95982,1549890,21,5,1992,5,female,190.0,975,141,3357,3744,2503,2485,854,1259
2950,35464,2090943,15,1,1998,1,male,68.0,50,28,0,4,0,0,0,4
2951,91428,1778234,95,16,1918,4,female,1386.0,538,317,42,8,33,3,9,5
2952,518,1194082,23,12,1990,7,male,13.0,0,0,0,0,0,0,0,0
2953,2931,1186476,44,29,1969,8,male,517.0,1,0,0,0,0,0,0,0
2954,33197,1978050,44,31,1969,1,male,610.0,44,10,46,0,46,0,0,0
2955,58656,1653912,17,5,1996,12,male,1170.0,112,45,16,4,1,1,15,3
2956,39755,1639383,24,15,1989,10,male,305.0,59,49,16,0,16,0,0,0
2957,75030,1840085,27,4,1986,10,female,282.0,211,184,504,655,501,375,3,280
2958,3000,1818095,49,8,1964,3,male,289.0,1,1,0,0,0,0,0,0
2959,78045,1139409,40,3,1973,3,male,711.0,239,146,427,428,425,353,2,75
2960,56267,1807036,39,9,1974,8,female,1566.0,104,68,494,150,494,125,0,25
2961,27014,2144427,27,16,1986,8,male,128.0,35,29,3,20,0,10,3,10
2962,32142,1872117,75,24,1938,12,female,858.0,43,28,49,0,9,0,40,0
2963,84279,1790313,69,22,1944,4,female,119.0,329,133,2,1,2,1,0,0
2964,36385,1646200,45,13,1968,5,male,261.0,51,27,257,91,257,83,0,8
2965,28614,1754601,22,5,1991,5,male,451.0,38,29,1,1,0,0,1,1
2966,16254,2068291,21,20,1992,3,male,174.0,18,16,130,3,0,3,130,0
2967,35610,1128947,41,19,1972,8,male,498.0,50,50,0,0,0,0,0,0
2968,67143,1599725,39,21,1974,5,male,1023.0,156,56,352,609,119,263,233,346
2969,44286,1834804,23,25,1990,1,male,111.0,69,32,0,7,0,5,0,2
2970,14806,1512760,69,12,1944,10,female,260.0,17,17,1,1,1,1,0,0
2971,54558,1309236,16,23,1997,6,male,218.0,98,84,2,0,2,0,0,0
2972,22628,2022892,68,5,1945,4,male,711.0,28,17,0,6,0,2,0,4
2973,7537,1055410,26,25,1987,4,male,90.0,7,7,0,0,0,0,0,0
2974,95815,1664451,21,28,1992,5,male,751.0,983,659,845,969,647,829,198,140
2975,33136,1071853,51,21,1962,3,female,1156.0,45,23,30,3,30,2,0,1
2976,81607,1681396,23,10,1990,10,male,486.0,284,151,51,110,3,18,48,92
2977,41989,1408919,25,7,1988,11,female,233.0,63,33,32,50,32,40,0,10
2978,39308,1932734,27,24,1986,8,male,487.0,59,38,0,0,0,0,0,0
2979,62234,1164463,17,1,1996,6,male,538.0,134,60,0,0,0,0,0,0
2980,28267,1669541,17,28,1996,3,male,203.0,36,30,265,36,265,19,0,17
2981,34811,1439594,35,15,1978,10,female,56.0,48,21,2,7,2,4,0,3
2982,30809,1767925,25,1,1988,1,female,179.0,40,30,15,8,15,6,0,2
2983,95611,1358236,19,11,1994,8,female,524.0,895,681,277,479,277,331,0,148
2984,44768,1856661,28,31,1985,7,male,412.0,70,45,26,3,26,3,0,0
2985,47670,1624273,16,10,1997,10,female,340.0,77,38,1,1,1,1,0,0
2986,66288,1849686,22,26,1991,12,male,1452.0,152,92,0,0,0,0,0,0
2987,45151,1833613,22,18,1991,7,female,491.0,72,56,0,0,0,0,0,0
2988,88405,1269295,14,15,1999,2,female,206.0,434,111,17,53,6,29,11,24
2989,36244,1968345,74,17,1939,2,male,1585.0,50,28,70,4,67,3,3,1
2990,35014,1131516,69,31,1944,7,male,55.0,49,45,13,0,13,0,0,0
2991,71303,1784199,23,9,1990,7,male,1437.0,183,85,1,28,1,28,0,0
2992,30108,1775425,17,2,1996,9,female,573.0,40,16,0,0,0,0,0,0
2993,90817,1116720,23,8,1990,9,male,431.0,495,379,319,166,127,53,192,113
2994,76056,1397429,48,8,1965,12,female,717.0,219,108,411,672,407,465,4,207
2995,4751,1969110,60,1,1953,4,male,78.0,2,0,10,9,10,9,0,0
2996,16263,1519432,30,16,1983,9,male,409.0,18,9,144,11,144,10,0,1
2997,33062,1919376,20,28,1993,1,female,229.0,45,36,19,74,17,27,2,47
2998,33048,1277020,61,4,1952,11,male,112.0,44,30,17,4,17,4,0,0
2999,56572,1385982,27,9,1986,10,male,1192.0,106,34,3,7,0,4,3,3
3000,54638,1095247,40,15,1973,1,male,589.0,99,73,4,1,4,1,0,0
3001,86017,1124627,16,11,1997,9,female,300.0,349,84,676,554,673,537,3,17
3002,78030,1129338,44,25,1969,12,female,511.0,236,140,389,286,389,205,0,81
3003,52169,1181980,22,10,1991,5,male,81.0,89,55,302,0,302,0,0,0
3004,24798,1997202,42,2,1971,1,male,299.0,31,15,3,10,3,6,0,4
3005,83383,1596310,22,2,1991,8,male,120.0,318,283,7,25,7,20,0,5
3006,45435,1787806,17,10,1996,5,female,484.0,71,29,2,5,2,1,0,4
3007,14838,1072603,29,10,1984,2,male,466.0,17,11,2,0,0,0,2,0
3008,53161,1699901,15,1,1998,11,male,364.0,95,72,0,0,0,0,0,0
3009,45381,1034192,21,7,1992,6,male,328.0,71,42,1,17,1,14,0,3
3010,62777,1971911,23,16,1990,10,female,220.0,131,93,30,23,29,14,1,9
3011,7351,1727807,17,5,1996,3,male,176.0,7,6,0,0,0,0,0,0
3012,26940,1473908,23,7,1990,2,female,361.0,34,29,2,6,0,4,2,2
3013,7002,1731124,66,27,1947,9,female,102.0,5,4,2,1,0,0,2,1
3014,29426,1033297,13,29,2000,4,male,33.0,38,32,336,50,0,26,336,24
3015,23496,1902694,70,28,1943,6,female,1240.0,29,12,0,0,0,0,0,0
3016,21671,1693732,23,12,1990,4,male,64.0,27,22,1,7,1,7,0,0
3017,27286,2060538,19,9,1994,2,male,101.0,34,34,14,0,14,0,0,0
3018,61553,2127301,31,14,1982,2,male,440.0,128,122,8,3,6,1,2,2
3019,27302,2081409,104,9,1909,8,female,1205.0,35,28,16,1,0,0,16,1
3020,94312,1180772,19,23,1994,4,female,637.0,741,322,25,62,25,46,0,16
3021,69162,1977153,23,22,1990,7,female,74.0,169,146,705,170,705,93,0,77
3022,95371,2076189,25,28,1988,2,female,434.0,892,690,67,242,67,192,0,50
3023,27199,1025235,27,27,1986,1,male,156.0,34,10,8,21,8,21,0,0
3024,75250,1170255,108,12,1905,2,female,993.0,216,159,1,15,0,6,1,9
3025,56190,1079941,44,20,1969,8,male,79.0,104,101,217,148,217,28,0,120
3026,58416,1460384,17,2,1996,4,male,147.0,113,86,2,0,2,0,0,0
3027,81236,1253880,23,28,1990,10,female,620.0,286,118,1,5,1,5,0,0
3028,27224,1391955,37,17,1976,5,female,204.0,34,29,9,17,9,12,0,5
3029,50075,2018776,42,21,1971,3,female,242.0,82,64,84,53,84,36,0,17
3030,92454,1201170,19,3,1994,1,male,638.0,604,415,55,58,55,23,0,35
3031,44429,1703251,26,14,1987,4,male,494.0,69,15,1,1,1,1,0,0
3032,82068,1264331,22,4,1991,5,female,273.0,279,110,1092,742,1092,594,0,148
3033,33381,2121874,30,6,1983,11,male,458.0,44,14,277,360,58,129,219,231
3034,58284,1360683,30,3,1983,1,male,274.0,112,106,0,0,0,0,0,0
3035,88619,1383941,19,24,1994,5,male,653.0,425,401,77,39,36,33,41,6
3036,87628,1543167,63,28,1950,1,male,536.0,405,50,72,30,0,5,72,25
3037,42648,1929130,69,28,1944,3,female,1225.0,66,28,1,6,0,1,1,5
3038,67677,1133557,80,24,1933,3,male,1985.0,162,83,21,6,6,1,15,5
3039,36283,1804784,45,4,1968,10,female,594.0,50,34,94,9,94,3,0,6
3040,84117,1885612,54,5,1959,6,female,850.0,308,125,8347,5191,2574,2506,5773,2685
3041,97772,1762430,37,28,1976,4,female,1121.0,1282,1011,1007,845,461,246,546,599
3042,47166,1917279,107,27,1906,11,female,755.0,76,39,56,22,56,17,0,5
3043,43134,1377126,18,5,1995,3,female,161.0,65,40,49,29,49,10,0,19
3044,10934,1311579,28,31,1985,12,male,325.0,11,6,0,0,0,0,0,0
3045,75765,2097359,19,8,1994,7,female,461.0,217,184,62,88,62,46,0,42
3046,59794,1900929,52,1,1961,9,female,371.0,116,42,25,6,0,3,25,3
3047,9191,1388325,22,25,1991,9,male,6.0,8,5,4,11,4,3,0,8
3048,65337,1980829,21,4,1992,1,male,242.0,147,40,1,0,1,0,0,0
3049,32853,2011406,51,29,1962,4,male,331.0,44,27,4,11,4,9,0,2
3050,71511,1609077,16,11,1997,6,male,444.0,189,92,12,6,8,5,4,1
3051,91473,1344213,14,28,1999,2,male,283.0,524,256,55,61,4,26,51,35
3052,85311,1120728,21,14,1992,7,male,537.0,344,301,4,21,4,18,0,3
3053,65055,1601831,65,26,1948,5,female,1534.0,142,52,445,329,0,26,445,303
3054,34855,1972726,39,7,1974,5,male,207.0,48,41,3,17,3,10,0,7
3055,91726,1653304,18,7,1995,8,male,564.0,557,423,256,65,185,31,71,34
3056,12601,1508996,57,27,1956,2,female,625.0,13,11,0,0,0,0,0,0
3057,33161,1589650,49,8,1964,10,female,583.0,45,22,37,41,0,12,37,29
3058,61384,1121198,21,25,1992,3,male,406.0,126,43,2,0,1,0,1,0
3059,17012,1317541,46,5,1967,6,male,90.0,19,16,3,5,3,3,0,2
3060,6027,1910340,38,15,1975,12,male,262.0,4,4,0,1,0,0,0,1
3061,92943,1334218,17,30,1996,8,female,1096.0,615,276,977,847,29,402,948,445
3062,82556,1800027,14,19,1999,5,male,378.0,295,252,32,8,32,7,0,1
3063,45419,1460145,18,19,1995,4,male,240.0,72,57,2,0,2,0,0,0
3064,47241,2146518,49,26,1964,4,female,1356.0,76,36,95,142,89,73,6,69
3065,7236,1627656,20,13,1993,11,female,583.0,5,3,31,11,13,1,18,10
3066,83374,1430458,17,3,1996,1,male,537.0,317,271,7,2,6,1,1,1
3067,13797,1468726,83,4,1930,6,female,477.0,15,11,0,0,0,0,0,0
3068,78990,1310532,20,3,1993,2,female,812.0,242,98,429,378,429,300,0,78
3069,67228,1303373,52,3,1961,12,female,245.0,151,121,3431,80,3431,43,0,37
3070,28924,1976286,17,24,1996,5,male,195.0,37,27,7,5,0,0,7,5
3071,57593,1011538,49,2,1964,2,male,339.0,111,89,8,14,8,8,0,6
3072,51404,1967914,41,27,1972,9,female,464.0,89,47,0,0,0,0,0,0
3073,64049,1603722,66,1,1947,12,male,1342.0,136,89,194,205,136,81,58,124
3074,67694,1730080,26,1,1987,2,male,346.0,161,119,23,43,23,28,0,15
3075,87959,1356388,22,13,1991,9,male,332.0,404,233,567,761,553,612,14,149
3076,65355,2015025,16,1,1997,12,male,342.0,148,55,1,7,1,6,0,1
3077,91444,2086554,19,22,1994,3,female,604.0,563,375,45,201,45,91,0,110
3078,49777,1463079,80,29,1933,7,female,1718.0,83,46,12,2,8,1,4,1
3079,16057,1406152,27,2,1986,7,female,192.0,18,9,9,13,8,6,1,7
3080,5060,1516995,25,1,1988,1,male,262.0,3,3,0,0,0,0,0,0
3081,39576,1362067,22,14,1991,12,female,534.0,59,26,4,11,4,6,0,5
3082,28627,1260614,22,18,1991,1,male,203.0,38,11,1,41,0,12,1,29
3083,63770,2126770,23,6,1990,1,female,455.0,136,65,26,69,26,67,0,2
3084,49284,1062060,15,3,1998,3,male,73.0,84,62,0,0,0,0,0,0
3085,86630,1666986,20,15,1993,6,male,482.0,368,263,70,18,19,18,51,0
3086,30851,1759769,38,1,1975,4,male,174.0,40,25,19,11,19,3,0,8
3087,49748,1801514,62,27,1951,3,male,166.0,83,57,9,23,9,5,0,18
3088,82344,1418550,36,15,1977,11,male,275.0,294,151,5,4,5,3,0,1
3089,11846,1295514,37,10,1976,7,male,40.0,12,2,1,1,1,1,0,0
3090,1718,1688063,23,10,1990,10,male,66.0,0,0,1,1,0,1,1,0
3091,68577,2022310,18,16,1995,3,male,198.0,165,111,10,11,10,4,0,7
3092,87448,1130411,15,11,1998,9,male,321.0,400,305,22,29,3,5,19,24
3093,81289,1483210,19,27,1994,10,female,146.0,285,181,3,9,3,9,0,0
3094,47716,1578118,108,31,1905,12,male,2296.0,78,40,2,2,2,2,0,0
3095,88103,2189292,93,18,1920,5,male,829.0,392,292,2465,903,2465,738,0,165
3096,41604,1518791,17,6,1996,1,male,96.0,64,63,4,17,4,13,0,4
3097,94747,1347288,38,13,1975,1,female,1102.0,739,415,379,780,222,445,157,335
3098,73423,1590850,43,1,1970,4,male,348.0,203,103,7,12,7,11,0,1
3099,45407,1251010,21,7,1992,10,male,329.0,72,51,2,24,0,2,2,22
3100,88855,1850892,76,17,1937,9,female,1381.0,439,190,290,87,11,36,279,51
3101,17674,1809948,14,22,1999,9,male,276.0,21,10,0,0,0,0,0,0
3102,57230,1710799,25,1,1988,1,male,214.0,108,22,0,0,0,0,0,0
3103,55424,2104344,32,21,1981,10,male,479.0,104,82,1,1,0,1,1,0
3104,77962,1490653,66,4,1947,10,male,800.0,238,164,238,127,238,97,0,30
3105,85865,1898988,20,18,1993,9,female,444.0,342,307,222,364,121,259,101,105
3106,55139,1831148,39,23,1974,7,female,267.0,98,40,226,43,226,43,0,0
3107,67016,1433954,25,1,1988,1,male,209.0,151,53,141,179,141,126,0,53
3108,98650,1144745,46,19,1967,1,male,1423.0,4615,702,840,1896,347,772,493,1124
3109,18584,1107251,32,4,1981,7,female,428.0,23,11,0,0,0,0,0,0
3110,36220,1737731,17,1,1996,11,male,86.0,50,32,56,26,32,15,24,11
3111,33657,1018932,72,20,1941,12,male,674.0,46,31,0,0,0,0,0,0
3112,8510,1744529,66,14,1947,11,male,395.0,7,5,19,0,0,0,19,0
3113,48720,1981383,25,8,1988,11,male,71.0,79,69,11,0,1,0,10,0
3114,81367,2004461,105,30,1908,4,female,597.0,281,62,7,40,7,20,0,20
3115,91140,1565024,15,6,1998,6,male,644.0,537,417,1,0,1,0,0,0
3116,5638,1492993,20,13,1993,5,male,439.0,3,2,10,1,8,1,2,0
3117,91820,1950491,15,7,1998,6,female,98.0,571,293,428,793,389,193,39,600
3118,73637,1815442,18,5,1995,5,male,31.0,199,88,38,57,34,20,4,37
3119,13869,1841892,37,13,1976,3,female,263.0,15,12,1,1,1,0,0,1
3120,37987,1038896,36,6,1977,12,male,612.0,54,26,23,39,23,25,0,14
3121,54992,1888841,36,31,1977,3,female,263.0,99,59,66,156,24,38,42,118
3122,74129,1114577,18,25,1995,10,male,517.0,207,190,0,0,0,0,0,0
3123,94288,1265147,19,6,1994,11,male,597.0,746,385,20,0,20,0,0,0
3124,42026,1348137,30,23,1983,3,male,194.0,63,14,39,25,38,9,1,16
3125,67356,1147603,54,14,1959,10,male,1714.0,160,39,0,0,0,0,0,0
3126,94863,1285965,17,16,1996,4,female,362.0,817,499,783,425,783,258,0,167
3127,53617,1934856,31,29,1982,7,female,59.0,96,36,7,13,7,13,0,0
3128,56613,1233316,24,14,1989,8,female,55.0,106,99,4,22,4,3,0,19
3129,80308,2191261,15,22,1998,5,male,412.0,274,217,4,2,0,0,4,2
3130,52063,1418211,18,7,1995,7,male,180.0,89,75,122,50,122,48,0,2
3131,64897,2054860,21,15,1992,5,male,1080.0,142,91,101,33,19,16,82,17
3132,66275,1157786,18,2,1995,7,male,503.0,156,104,0,0,0,0,0,0
3133,50225,2128057,23,7,1990,7,female,309.0,84,62,356,60,356,56,0,4
3134,37221,1255930,50,8,1963,12,male,937.0,52,47,63,65,49,28,14,37
3135,74192,1575250,28,1,1985,3,male,680.0,210,206,0,6,0,3,0,3
3136,78237,1163009,37,28,1976,7,male,296.0,249,199,0,1,0,1,0,0
3137,19504,1291659,65,19,1948,10,female,625.0,22,19,30,13,30,4,0,9
3138,19664,1466666,55,12,1958,7,male,281.0,23,14,119,69,119,52,0,17
3139,34885,1130498,34,1,1979,8,male,547.0,48,36,4,8,4,5,0,3
3140,28263,2076809,57,26,1956,7,female,464.0,36,26,257,123,0,72,257,51
3141,40426,1367347,19,9,1994,12,male,476.0,61,44,4,0,0,0,4,0
3142,38952,1442050,22,7,1991,1,male,62.0,57,35,42,0,42,0,0,0
3143,69117,1571575,23,9,1990,1,female,274.0,167,124,433,474,284,155,149,319
3144,90535,1477421,33,22,1980,5,male,390.0,477,449,68,4,68,2,0,2
3145,43191,2113499,23,19,1990,2,male,235.0,65,41,71,2,71,2,0,0
3146,6641,1826660,26,20,1987,3,female,223.0,5,3,0,0,0,0,0,0
3147,58176,1905622,38,23,1975,7,male,389.0,108,89,1811,1036,797,643,1014,393
3148,30771,1172751,74,15,1939,12,female,1756.0,40,21,12,7,0,0,12,7
3149,51612,1447897,19,12,1994,3,male,9.0,88,84,5,0,5,0,0,0
3150,86036,1996973,18,28,1995,12,female,163.0,352,75,800,483,800,239,0,244
3151,67047,1676278,23,30,1990,11,male,197.0,152,130,168,18,77,12,91,6
3152,48400,1184531,68,26,1945,2,male,894.0,79,54,0,0,0,0,0,0
3153,91859,1330734,22,5,1991,6,male,798.0,567,460,537,349,537,316,0,33
3154,66650,1984364,21,1,1992,11,male,552.0,154,107,13,0,13,0,0,0
3155,26184,1444038,76,9,1937,6,female,1117.0,33,10,35,11,0,7,35,4
3156,64805,1764886,32,25,1981,6,female,390.0,143,91,49,44,44,22,5,22
3157,12781,1792499,91,21,1922,9,male,45.0,14,14,1,0,1,0,0,0
3158,83424,1836147,20,3,1993,3,male,536.0,311,277,11,5,11,5,0,0
3159,21751,1484635,28,10,1985,6,male,343.0,26,13,2,2,2,0,0,2
3160,63496,1585368,19,28,1994,6,male,119.0,135,125,3,0,3,0,0,0
3161,24777,1261222,44,17,1969,12,male,194.0,31,30,3,0,0,0,3,0
3162,13107,1393727,36,10,1977,12,male,397.0,13,12,7,0,0,0,7,0
3163,76048,1952987,63,7,1950,5,female,1309.0,216,158,393,63,217,28,176,35
3164,8275,2032789,63,6,1950,10,male,1166.0,7,0,4,1,2,0,2,1
3165,94621,1020248,18,4,1995,3,female,1575.0,732,450,195,746,176,372,19,374
3166,46494,1672492,59,27,1954,2,male,753.0,74,45,0,1,0,1,0,0
3167,11933,1602383,67,22,1946,9,female,254.0,12,1,4,0,4,0,0,0
3168,308,1251517,20,30,1993,1,male,508.0,0,0,0,0,0,0,0,0
3169,47273,1060600,61,20,1952,9,male,710.0,74,24,116,7,116,5,0,2
3170,12962,2138778,28,23,1985,6,male,2.0,14,14,3,0,3,0,0,0
3171,74167,1611442,23,28,1990,1,male,549.0,211,118,0,4,0,2,0,2
3172,12055,1412626,17,27,1996,11,male,204.0,12,10,19,3,0,0,19,3
3173,5617,1067382,23,25,1990,7,male,500.0,3,2,8,0,0,0,8,0
3174,71338,1419081,42,2,1971,10,male,355.0,183,152,2,0,2,0,0,0
3175,54998,1439011,17,19,1996,3,male,270.0,99,36,69,44,63,23,6,21
3176,27074,1702078,44,22,1969,12,male,626.0,34,21,4,2,4,1,0,1
3177,86945,1985848,19,11,1994,11,male,721.0,368,317,437,90,437,74,0,16
3178,58566,2005467,25,18,1988,6,male,178.0,113,81,8,0,8,0,0,0
3179,1625,1698255,61,21,1952,8,male,19.0,0,0,0,0,0,0,0,0
3180,59813,1132182,22,13,1991,4,male,405.0,117,73,28,4,0,2,28,2
3181,37677,1068916,19,14,1994,9,male,253.0,54,28,2,2,2,1,0,1
3182,89712,1115916,23,4,1990,3,male,393.0,471,342,152,54,147,46,5,8
3183,16306,1294061,16,7,1997,8,female,59.0,19,12,0,3,0,0,0,3
3184,45354,1061531,103,1,1910,4,female,429.0,73,56,1,0,1,0,0,0
3185,24692,1880553,64,7,1949,3,male,1084.0,31,18,1,23,0,21,1,2
3186,67255,1660513,17,2,1996,5,male,194.0,158,145,0,17,0,10,0,7
3187,90043,1153969,13,5,2000,1,female,302.0,458,359,1786,722,1260,481,526,241
3188,66126,1579093,17,5,1996,3,female,307.0,147,50,321,81,321,56,0,25
3189,92049,2021141,16,27,1997,12,male,527.0,610,518,0,0,0,0,0,0
3190,81213,1931172,18,13,1995,4,male,187.0,286,273,1,0,1,0,0,0
3191,78159,1875874,16,3,1997,3,female,117.0,248,231,0,0,0,0,0,0
3192,22096,1405318,16,2,1997,8,male,215.0,26,20,15,1,15,1,0,0
3193,48786,1169063,58,18,1955,12,male,1492.0,81,27,16,26,14,14,2,12
3194,29650,1740584,22,17,1991,2,male,382.0,39,9,1,18,0,9,1,9
3195,47126,1500939,22,22,1991,10,female,469.0,74,56,47,1,12,1,35,0
3196,4457,1808616,73,7,1940,10,male,554.0,2,1,0,0,0,0,0,0
3197,81752,1168786,108,1,1905,1,male,1246.0,282,111,113,89,16,63,97,26
3198,578,1682582,24,3,1989,5,female,66.0,0,0,0,0,0,0,0,0
3199,19421,1844051,39,7,1974,4,female,431.0,23,12,21,18,21,14,0,4
3200,59384,1485892,66,30,1947,1,female,457.0,119,75,1,3,0,2,1,1
3201,79311,1452923,19,23,1994,4,male,467.0,258,117,4,2,1,0,3,2
3202,60987,1092262,56,21,1957,9,female,170.0,121,92,148,58,0,26,148,32
3203,58142,1306339,57,15,1956,6,female,1731.0,111,66,579,286,579,234,0,52
3204,43080,1690794,29,29,1984,2,male,551.0,65,51,32,17,32,6,0,11
3205,41944,1017910,43,10,1970,7,male,349.0,64,44,26,10,22,5,4,5
3206,53550,1627607,108,1,1905,1,male,1109.0,95,36,5,6,0,0,5,6
3207,33668,1117075,89,12,1924,5,male,537.0,46,12,0,7,0,3,0,4
3208,88157,1351065,22,20,1991,3,male,437.0,420,205,0,20,0,7,0,13
3209,34121,1370027,26,13,1987,3,male,337.0,47,21,22,3,22,2,0,1
3210,95886,1065456,14,27,1999,2,female,420.0,850,413,1201,944,1201,796,0,148
3211,55706,1629569,18,24,1995,9,male,217.0,104,34,9,5,9,2,0,3
3212,24392,1549626,59,31,1954,12,female,74.0,29,26,114,2,88,2,26,0
3213,34374,1358166,64,13,1949,7,female,1556.0,47,24,171,59,116,32,55,27
3214,41125,2012904,21,26,1992,3,male,566.0,64,47,0,0,0,0,0,0
3215,92285,1458562,22,12,1991,1,male,466.0,630,333,15,32,15,30,0,2
3216,69888,1371476,38,1,1975,7,female,1683.0,174,114,103,126,103,120,0,6
3217,44354,1063130,39,11,1974,3,male,508.0,69,58,0,0,0,0,0,0
3218,22768,1169406,57,19,1956,2,male,580.0,28,13,3,2,3,2,0,0
3219,55006,1446921,65,12,1948,2,female,1653.0,98,70,76,27,75,22,1,5
3220,45989,1003723,19,1,1994,1,male,328.0,73,54,63,140,63,135,0,5
3221,82275,1679437,19,20,1994,2,female,196.0,292,30,2,50,2,42,0,8
3222,98846,1865407,65,25,1948,8,male,1541.0,2860,1503,2046,1702,1832,1081,214,621
3223,29948,2121797,33,26,1980,10,male,437.0,39,26,51,64,51,45,0,19
3224,12865,1934050,58,16,1955,4,female,1930.0,13,6,2,1,1,1,1,0
3225,32115,1498789,34,24,1979,6,female,424.0,43,39,37,11,37,10,0,1
3226,42202,1727090,42,1,1971,5,male,276.0,62,31,85,7,75,6,10,1
3227,92167,1211240,20,11,1993,8,female,602.0,620,155,3,5,3,5,0,0
3228,35775,1240815,30,12,1983,11,female,466.0,51,26,2,0,2,0,0,0
3229,48113,1240982,19,20,1994,2,male,5.0,78,78,130,47,130,26,0,21
3230,47614,1225936,62,20,1951,9,male,1161.0,78,15,0,0,0,0,0,0
3231,55475,1748355,24,15,1989,8,female,316.0,103,42,1,74,1,18,0,56
3232,96200,1212317,63,24,1950,10,male,1546.0,1116,717,14,66,14,43,0,23
3233,71439,1539619,18,31,1995,8,male,559.0,190,159,6,5,6,3,0,2
3234,39467,2007457,20,9,1993,11,female,639.0,58,24,1,5,1,2,0,3
3235,87106,2066988,19,12,1994,12,male,726.0,362,225,2540,342,941,225,1599,117
3236,64246,1247572,18,17,1995,3,male,216.0,141,96,0,0,0,0,0,0
3237,11649,1017360,29,17,1984,5,male,175.0,12,10,0,1,0,0,0,1
3238,67109,1727482,55,29,1958,9,male,860.0,151,71,273,393,137,233,136,160
3239,3091,1059673,63,29,1950,4,female,383.0,1,0,0,0,0,0,0,0
3240,15341,2157500,22,1,1991,1,male,128.0,16,14,31,1,30,0,1,1
3241,70620,1143783,27,17,1986,1,female,338.0,182,86,19,16,19,16,0,0
3242,63144,2117500,37,25,1976,4,female,608.0,134,70,408,77,408,44,0,33
3243,45786,1159547,18,29,1995,8,male,95.0,71,47,21,0,21,0,0,0
3244,16146,1026898,108,14,1905,9,male,8.0,18,18,22,5,22,5,0,0
3245,75217,1872862,41,17,1972,2,male,508.0,216,152,0,0,0,0,0,0
3246,55150,1114593,43,30,1970,3,female,345.0,99,59,256,302,0,66,256,236
3247,13323,1715901,23,4,1990,12,female,47.0,13,10,23,7,23,7,0,0
3248,72958,1327078,20,1,1993,1,male,470.0,196,131,239,46,114,7,125,39
3249,25747,1998079,59,22,1954,8,female,1123.0,32,16,3,5,3,5,0,0
3250,49133,1117819,65,26,1948,5,female,838.0,81,45,186,67,5,42,181,25
3251,66360,1084149,63,8,1950,12,female,583.0,152,89,0,0,0,0,0,0
3252,2282,1675604,23,10,1990,1,male,66.0,1,1,0,1,0,1,0,0
3253,96747,2083022,18,22,1995,3,female,459.0,1265,767,791,4359,270,2826,521,1533
3254,54224,1985915,62,21,1951,10,female,1696.0,97,33,225,114,93,68,132,46
3255,59207,2144790,16,6,1997,1,female,266.0,119,72,0,0,0,0,0,0
3256,81940,2076779,19,7,1994,6,female,209.0,276,59,358,921,251,434,107,487
3257,55157,1858164,36,19,1977,7,female,43.0,98,76,267,189,267,142,0,47
3258,73108,1792753,53,24,1960,3,female,1106.0,194,118,3302,968,3302,570,0,398
3259,66544,1949517,18,31,1995,12,female,190.0,156,101,6,7,1,3,5,4
3260,38948,1372387,103,1,1910,1,female,1687.0,56,31,42,99,0,25,42,74
3261,81713,2110717,23,4,1990,12,male,355.0,276,158,88,13,88,10,0,3
3262,88688,1812716,16,27,1997,7,male,192.0,418,394,113,71,43,58,70,13
3263,80968,2105911,55,7,1958,2,female,1296.0,270,163,363,222,44,132,319,90
3264,66008,1529203,28,3,1985,9,male,1108.0,150,110,148,37,119,30,29,7
3265,68720,1978037,113,10,1900,8,female,1535.0,169,60,28,14,16,10,12,4
3266,2063,1774024,17,7,1996,5,male,428.0,1,0,0,0,0,0,0,0
3267,14664,1578601,63,22,1950,6,male,1933.0,16,7,0,0,0,0,0,0
3268,40037,1898320,64,6,1949,10,male,549.0,58,29,182,87,182,33,0,54
3269,18131,1305207,71,18,1942,12,female,430.0,21,17,10,2,0,0,10,2
3270,47731,2089917,63,20,1950,7,female,398.0,78,25,3,3,0,3,3,0
3271,49677,1747987,79,23,1934,9,female,1625.0,82,21,5,5,5,4,0,1
3272,20359,1781266,37,12,1976,10,male,379.0,24,5,29,5,29,4,0,1
3273,18414,1734186,18,26,1995,6,male,307.0,22,20,0,1,0,1,0,0
3274,23662,1064543,59,14,1954,5,male,1739.0,30,12,1,2,1,2,0,0
3275,1413,1148734,44,23,1969,9,male,184.0,0,0,0,0,0,0,0,0
3276,58489,2191409,25,24,1988,2,male,251.0,113,98,4,0,3,0,1,0
3277,55721,1608435,21,13,1992,1,male,172.0,102,73,10,6,10,5,0,1
3278,27398,1456736,15,20,1998,9,male,224.0,35,20,31,25,20,20,11,5
3279,27611,1253577,33,24,1980,12,female,283.0,34,7,189,92,189,79,0,13
3280,31856,1003606,18,27,1995,4,male,218.0,42,35,7,25,7,11,0,14
3281,57694,2112491,33,1,1980,1,male,305.0,109,58,18,4,18,2,0,2
3282,35605,1194407,39,26,1974,8,male,526.0,51,32,0,2,0,2,0,0
3283,7113,2079430,106,30,1907,4,male,34.0,5,1,5,6,0,3,5,3
3284,28446,1857601,28,10,1985,1,male,140.0,37,37,0,0,0,0,0,0
3285,18108,1488861,54,4,1959,1,female,490.0,21,12,7,6,7,6,0,0
3286,31002,1555171,19,24,1994,9,female,122.0,41,30,48,1,0,0,48,1
3287,35177,1324249,24,23,1989,7,female,136.0,48,27,38,73,28,51,10,22
3288,54023,1154823,30,24,1983,10,male,300.0,94,68,65,43,65,43,0,0
3289,46148,1570196,30,20,1983,2,female,582.0,73,48,211,153,36,79,175,74
3290,50139,2150451,33,12,1980,3,female,545.0,83,51,142,15,142,15,0,0
3291,6870,1783336,62,5,1951,9,,2047.0,5,0,0,1,0,1,0,0
3292,97961,2109614,23,4,1990,2,female,473.0,1767,1446,3599,1827,2255,901,1344,926
3293,56203,1689668,19,24,1994,3,female,545.0,101,43,249,142,243,91,6,51
3294,62969,1225678,30,1,1983,9,female,295.0,131,53,99,94,99,55,0,39
3295,85814,1229352,108,31,1905,1,male,52.0,342,234,170,199,61,80,109,119
3296,42145,2084267,21,4,1992,3,female,220.0,64,51,65,5,17,0,48,5
3297,60991,1204037,20,1,1993,1,male,230.0,124,23,148,83,148,56,0,27
3298,76138,1239132,57,3,1956,1,male,547.0,220,28,1264,1488,743,538,521,950
3299,57421,2132549,52,27,1961,8,female,443.0,109,83,2,1,2,0,0,1
3300,95284,2062775,29,19,1984,2,male,371.0,862,789,37,4,37,1,0,3
3301,31907,2149853,32,3,1981,6,male,366.0,43,34,10,16,2,14,8,2
3302,33188,1272207,73,27,1940,5,female,1518.0,45,28,43,0,43,0,0,0
3303,37211,1850620,52,2,1961,4,female,94.0,53,38,55,39,54,35,1,4
3304,87060,1054180,15,2,1998,4,female,503.0,376,225,1018,232,940,210,78,22
3305,85039,1174270,18,19,1995,3,female,193.0,328,57,1021,816,1021,652,0,164
3306,9107,2084958,24,19,1989,7,female,774.0,8,8,2,4,0,0,2,4
3307,40765,2115131,20,1,1993,5,male,228.0,60,39,52,3,52,0,0,3
3308,46824,1254856,19,6,1994,4,male,581.0,76,62,7,34,2,10,5,24
3309,75454,2067132,16,2,1997,5,male,130.0,216,153,10,0,0,0,10,0
3310,19563,1218803,28,24,1985,12,female,404.0,23,12,48,0,48,0,0,0
3311,5227,1809627,37,5,1976,9,male,376.0,3,3,0,1,0,1,0,0
3312,5678,1320467,107,3,1906,3,male,75.0,3,3,19,22,19,5,0,17
3313,31094,1910384,48,19,1965,2,female,171.0,41,26,89,47,0,19,89,28
3314,71222,1533752,29,4,1984,3,male,317.0,190,86,0,0,0,0,0,0
3315,74900,1621651,25,8,1988,7,female,381.0,210,34,186,284,186,242,0,42
3316,68016,1955607,103,2,1910,9,male,1200.0,157,80,221,178,221,135,0,43
3317,16119,1462655,32,1,1981,5,female,322.0,18,12,19,2,0,0,19,2
3318,97215,1004515,19,14,1994,9,male,1014.0,1375,1032,27,10,1,6,26,4
3319,49132,1170234,27,10,1986,10,female,407.0,80,55,175,157,175,134,0,23
3320,78924,1640933,17,10,1996,10,male,179.0,241,171,286,789,286,755,0,34
3321,4887,2093302,46,20,1967,1,male,161.0,2,0,182,53,83,52,99,1
3322,48067,1010385,71,1,1942,1,male,621.0,78,54,75,7,0,0,75,7
3323,63442,1862270,29,24,1984,7,male,781.0,137,84,1,14,1,9,0,5
3324,26857,1115676,25,1,1988,1,male,233.0,34,32,1,0,1,0,0,0
3325,87640,2013309,108,13,1905,10,male,1535.0,386,230,80,32,63,10,17,22
3326,41472,1509639,27,29,1986,5,male,157.0,62,34,2,0,2,0,0,0
3327,4125,2188597,31,13,1982,2,male,600.0,2,0,0,0,0,0,0,0
3328,59251,1477509,20,21,1993,6,male,241.0,117,100,0,1,0,1,0,0
3329,87274,1946470,17,11,1996,9,female,596.0,405,234,3,12,3,11,0,1
3330,71399,1945486,18,21,1995,1,male,228.0,186,130,4,4,2,1,2,3
3331,46619,1073624,103,17,1910,2,male,691.0,74,54,1,2,1,1,0,1
3332,87,1962161,15,2,1998,3,male,45.0,0,0,0,0,0,0,0,0
3333,7816,1565808,48,25,1965,5,male,462.0,7,4,0,0,0,0,0,0
3334,20799,1238690,48,24,1965,3,male,375.0,25,21,2,1,2,0,0,1
3335,98806,2192435,17,23,1996,4,female,664.0,2517,508,1542,3212,1302,544,240,2668
3336,34458,2137529,55,26,1958,8,female,311.0,46,27,867,727,867,278,0,449
3337,16611,1174853,50,11,1963,1,male,150.0,19,16,0,13,0,4,0,9
3338,95679,1649066,16,11,1997,8,male,264.0,873,496,404,90,315,73,89,17
3339,45421,1372118,20,24,1993,11,female,126.0,73,32,2,0,2,0,0,0
3340,10849,1106554,16,30,1997,1,female,2.0,11,8,0,0,0,0,0,0
3341,38758,1918830,66,25,1947,9,male,118.0,57,38,9,3,9,3,0,0
3342,57062,1963939,17,6,1996,5,female,96.0,105,65,274,400,274,327,0,73
3343,39929,1584118,21,15,1992,12,male,79.0,59,56,65,21,51,11,14,10
3344,97286,1303330,103,21,1910,10,male,1477.0,1711,411,56,51,56,28,0,23
3345,53577,1380560,25,18,1988,5,male,142.0,96,88,6,67,0,15,6,52
3346,45084,1561128,15,24,1998,8,male,313.0,72,48,0,0,0,0,0,0
3347,88414,1215195,103,10,1910,5,male,1227.0,419,217,18,43,4,21,14,22
3348,84475,2077904,19,5,1994,11,female,256.0,329,255,19,72,19,23,0,49
3349,91386,1670502,21,1,1992,10,male,472.0,529,437,31,25,31,14,0,11
3350,85124,2139115,19,6,1994,10,male,495.0,347,315,0,9,0,7,0,2
3351,19856,1332354,29,23,1984,10,male,18.0,24,24,0,2,0,0,0,2
3352,11161,2149437,37,3,1976,10,male,313.0,11,7,1,0,1,0,0,0
3353,14320,1709523,20,2,1993,5,male,69.0,16,12,0,0,0,0,0,0
3354,29937,1317288,29,16,1984,11,male,695.0,39,25,42,17,42,16,0,1
3355,54272,1856874,49,3,1964,3,male,249.0,96,50,346,386,17,255,329,131
3356,26174,2069244,17,27,1996,10,male,910.0,33,13,33,3,33,1,0,2
3357,15154,1873121,62,4,1951,3,male,898.0,17,9,9,3,9,2,0,1
3358,6363,1496301,33,27,1980,11,female,222.0,4,1,6,12,3,0,3,12
3359,96560,1407257,22,20,1991,12,female,950.0,1030,343,280,232,220,151,60,81
3360,15213,1219290,19,18,1994,6,male,105.0,17,17,13,4,0,1,13,3
3361,72279,1035694,38,8,1975,1,female,1139.0,195,36,0,1,0,1,0,0
3362,66320,1358081,26,2,1987,2,male,291.0,155,88,0,0,0,0,0,0
3363,72925,1591858,18,12,1995,11,male,180.0,194,161,175,37,164,20,11,17
3364,4292,1545056,42,1,1971,1,female,220.0,2,2,0,0,0,0,0,0
3365,35640,1341158,55,27,1958,4,male,386.0,51,48,0,5,0,5,0,0
3366,30544,1528594,23,27,1990,7,female,201.0,40,31,3,0,3,0,0,0
3367,79863,1744815,14,13,1999,5,female,122.0,253,91,211,85,184,64,27,21
3368,70991,1709236,23,14,1990,5,male,351.0,177,142,252,61,252,61,0,0
3369,89452,1656861,16,8,1997,8,male,512.0,475,298,31,60,1,41,30,19
3370,30148,1812683,21,17,1992,4,male,739.0,41,14,0,0,0,0,0,0
3371,16130,1067683,27,14,1986,3,male,176.0,18,15,20,2,0,0,20,2
3372,80684,1218337,108,29,1905,11,female,1191.0,268,102,54,64,54,48,0,16
3373,55028,1935463,23,11,1990,10,female,377.0,99,41,90,160,90,124,0,36
3374,63728,1330939,25,16,1988,8,male,732.0,137,89,20,3,20,2,0,1
3375,85062,1206640,14,1,1999,5,female,341.0,321,236,1687,383,1620,274,67,109
3376,15562,1670383,28,9,1985,11,male,60.0,16,16,568,11,313,0,255,11
3377,54944,1010467,15,17,1998,1,male,291.0,100,76,44,7,44,5,0,2
3378,63646,1604206,36,15,1977,12,male,687.0,138,55,11,0,7,0,4,0
3379,28295,1099323,41,9,1972,11,male,468.0,36,29,768,13,768,11,0,2
3380,49633,2011732,24,4,1989,7,male,740.0,83,43,4,0,0,0,4,0
3381,9838,1565652,40,12,1973,2,male,282.0,9,8,0,0,0,0,0,0
3382,2997,1594818,50,6,1963,12,male,453.0,1,0,0,0,0,0,0,0
3383,91543,1915787,47,1,1966,11,male,781.0,553,323,88,71,8,35,80,36
3384,18232,1285614,64,17,1949,4,male,526.0,21,2,26,10,0,0,26,10
3385,75694,1062437,18,4,1995,4,female,393.0,213,56,41,69,41,60,0,9
3386,80849,1364121,57,13,1956,7,female,1506.0,265,199,146,76,67,40,79,36
3387,53389,1375900,104,9,1909,8,male,1354.0,96,66,1,0,1,0,0,0
3388,16416,1124458,25,1,1988,1,female,226.0,20,18,0,0,0,0,0,0
3389,93371,1067337,24,27,1989,11,male,304.0,706,622,36,557,31,381,5,176
3390,1914,1178042,25,15,1988,7,female,24.0,0,0,11,0,0,0,11,0
3391,84343,1472655,14,14,1999,9,female,121.0,329,21,5,21,5,17,0,4
3392,51629,1296189,53,27,1960,9,male,1587.0,90,33,5,36,5,27,0,9
3393,12809,1663344,29,3,1984,5,male,17.0,14,13,1,5,1,5,0,0
3394,58359,1898552,17,2,1996,6,female,422.0,112,15,1,1,1,0,0,1
3395,73674,1308861,24,17,1989,12,female,277.0,202,125,45,69,45,57,0,12
3396,61441,1240751,26,15,1987,10,female,685.0,125,107,3,3,3,1,0,2
3397,8928,1817124,43,1,1970,10,male,500.0,8,5,0,0,0,0,0,0
3398,89107,1161776,21,15,1992,8,female,1744.0,412,173,5544,3201,3193,1595,2351,1606
3399,52557,1534736,34,12,1979,11,female,712.0,93,55,4,6,1,2,3,4
3400,86188,2038203,26,11,1987,5,male,1005.0,364,245,0,2,0,2,0,0
3401,3782,1765607,15,12,1998,11,male,89.0,2,1,0,0,0,0,0,0
3402,12355,1633156,25,28,1988,6,female,244.0,13,10,0,0,0,0,0,0
3403,87929,1492197,108,6,1905,1,male,1340.0,385,271,471,270,0,165,471,105
3404,85220,1860089,22,1,1991,1,male,1600.0,346,169,1,4,1,4,0,0
3405,91242,1228050,103,23,1910,5,female,2180.0,522,189,6,13,0,11,6,2
3406,38090,1794112,53,30,1960,11,female,46.0,54,38,46,81,2,43,44,38
3407,35202,1720697,70,31,1943,8,male,994.0,49,17,49,560,0,83,49,477
3408,37848,1530537,65,8,1948,9,male,385.0,55,36,10,11,0,4,10,7
3409,70557,1030960,23,2,1990,12,male,648.0,180,134,12,39,12,19,0,20
3410,97091,1400829,35,6,1978,8,male,464.0,1490,1459,4,0,2,0,2,0
3411,1915,1988428,55,12,1958,9,female,772.0,0,0,11,0,0,0,11,0
3412,43190,2070266,56,21,1957,10,female,280.0,66,42,71,124,62,58,9,66
3413,80035,1119690,48,28,1965,8,female,1316.0,252,82,853,522,741,509,112,13
3414,22829,1123088,59,27,1954,5,male,1619.0,28,11,7,2,6,2,1,0
3415,65638,1365983,23,23,1990,1,female,807.0,150,81,15,4,0,0,15,4
3416,77537,1490015,14,28,1999,5,female,450.0,233,110,19,3,19,2,0,1
3417,36749,2081250,66,3,1947,4,male,722.0,53,16,2,0,0,0,2,0
3418,96768,2018875,21,26,1992,12,female,549.0,1098,368,856,173,499,43,357,130
3419,1952,1315337,15,15,1998,2,male,1.0,0,0,73,28,1,7,72,21
3420,7812,1379959,47,5,1966,10,male,376.0,7,5,0,0,0,0,0,0
3421,68511,2157744,21,20,1992,2,male,296.0,166,124,6,114,6,56,0,58
3422,28494,2172304,37,2,1976,2,female,874.0,37,22,0,1,0,1,0,0
3423,31394,1503996,29,11,1984,5,male,314.0,42,31,0,0,0,0,0,0
3424,9031,1132224,34,23,1979,12,male,585.0,8,6,1,6,0,0,1,6
3425,19431,1196378,51,13,1962,1,male,191.0,22,15,22,0,22,0,0,0
3426,60686,1797705,68,12,1945,1,male,446.0,124,8,14,3,14,3,0,0
3427,22100,2072475,37,15,1976,7,female,750.0,27,10,15,8,15,8,0,0
3428,11915,2177156,39,29,1974,10,male,483.0,12,4,3,2,3,2,0,0
3429,84018,1248224,62,14,1951,9,female,1817.0,304,91,609,98,154,39,455,59
3430,59692,1074148,28,19,1985,7,male,417.0,120,109,12,1,12,1,0,0
3431,30815,1443996,69,8,1944,1,male,1683.0,41,12,16,17,0,8,16,9
3432,29344,1831423,29,7,1984,3,male,328.0,37,19,112,75,13,25,99,50
3433,85667,1226847,96,22,1917,9,female,2177.0,351,146,80,455,20,235,60,220
3434,72945,1912951,52,2,1961,7,female,1363.0,195,90,220,123,220,65,0,58
3435,45021,1003465,43,20,1970,1,male,78.0,69,67,333,30,50,22,283,8
3436,39299,1689611,26,7,1987,8,male,418.0,58,23,0,0,0,0,0,0
3437,68509,2186300,18,14,1995,7,female,153.0,164,89,6,9,6,4,0,5
3438,26459,1155348,15,26,1998,11,female,6.0,35,30,0,3,0,2,0,1
3439,24664,1664538,61,12,1952,4,female,345.0,31,22,0,14,0,5,0,9
3440,51075,1702584,17,8,1996,3,female,244.0,86,30,86,14,86,9,0,5
3441,17357,1077274,27,2,1986,5,male,30.0,20,10,21,9,21,9,0,0
3442,13321,2065355,25,23,1988,6,female,504.0,13,8,23,2,17,2,6,0
3443,23442,1025417,55,12,1958,7,male,970.0,29,19,0,0,0,0,0,0
3444,40571,1788685,45,6,1968,6,male,783.0,60,17,11,8,11,5,0,3
3445,28737,1939130,28,9,1985,5,female,170.0,38,27,2,0,2,0,0,0
3446,31402,1850903,33,18,1980,12,male,105.0,42,22,0,1,0,1,0,0
3447,15325,1729619,63,5,1950,10,female,462.0,16,12,27,17,27,15,0,2
3448,33763,1909178,22,26,1991,4,female,659.0,47,23,2,1,0,0,2,1
3449,47054,1547772,28,1,1985,1,male,620.0,75,24,31,14,31,11,0,3
3450,64235,1251997,17,2,1996,2,male,562.0,141,109,0,0,0,0,0,0
3451,29012,1833898,43,30,1970,4,male,538.0,38,17,10,2,10,2,0,0
3452,47127,1798783,47,10,1966,4,female,879.0,74,40,47,2,42,2,5,0
3453,77385,2040179,15,1,1998,1,male,257.0,234,51,5,0,0,0,5,0
3454,34073,1966920,23,30,1990,1,female,260.0,46,21,16,66,11,35,5,31
3455,92242,2031583,21,28,1992,7,female,1439.0,607,206,9,50,9,39,0,11
3456,32954,1014845,52,23,1961,10,female,549.0,44,17,9,7,9,5,0,2
3457,22943,1326087,66,4,1947,4,female,826.0,28,17,23,11,0,10,23,1
3458,9716,1136159,29,18,1984,10,female,323.0,10,10,0,5,0,1,0,4
3459,75701,2043971,103,30,1910,9,male,635.0,214,129,44,43,44,24,0,19
3460,75246,1232062,36,7,1977,8,female,645.0,215,141,1,11,0,0,1,11
3461,56741,1107246,50,1,1963,12,female,752.0,105,44,17,52,1,19,16,33
3462,13061,1092159,32,12,1981,6,male,463.0,14,8,5,0,3,0,2,0
3463,24247,2176924,20,24,1993,8,male,562.0,29,24,43,7,20,5,23,2
3464,86178,1022051,24,2,1989,7,male,526.0,362,306,0,4,0,0,0,4
3465,46972,1452779,21,6,1992,8,female,485.0,75,54,19,64,19,59,0,5
3466,15873,1081130,23,28,1990,8,female,246.0,18,15,1,0,1,0,0,0
3467,26506,2190872,20,11,1993,8,male,315.0,34,18,0,0,0,0,0,0
3468,30916,2105118,78,22,1935,6,female,1930.0,40,6,28,1,28,0,0,1
3469,6054,1019997,42,15,1971,12,male,399.0,4,2,0,2,0,2,0,0
3470,14047,1625935,57,1,1956,6,male,624.0,15,10,8,7,0,1,8,6
3471,47891,1647299,26,8,1987,10,male,513.0,77,45,15,11,15,7,0,4
3472,73614,1968223,26,17,1987,7,male,142.0,203,177,32,52,32,37,0,15
3473,21691,1880749,48,1,1965,4,female,54.0,27,10,1,12,1,8,0,4
3474,69182,1629800,54,13,1959,2,female,296.0,165,66,1010,100,0,13,1010,87
3475,9896,1009285,48,23,1965,12,male,268.0,9,6,0,0,0,0,0,0
3476,87813,1941250,20,13,1993,8,female,350.0,394,246,214,271,214,227,0,44
3477,56255,1587416,54,19,1959,7,male,1187.0,101,52,410,505,0,81,410,424
3478,75207,1676815,31,8,1982,3,male,422.0,213,93,0,1,0,1,0,0
3479,78873,1919553,59,14,1954,12,male,757.0,243,173,191,51,55,32,136,19
3480,86658,1614255,22,22,1991,6,female,569.0,372,63,81,169,1,35,80,134
3481,68120,1769802,54,17,1959,8,female,1459.0,157,90,522,210,522,135,0,75
3482,87854,1891411,20,10,1993,1,male,879.0,395,130,263,355,263,331,0,24
3483,23795,1256304,15,4,1998,12,male,151.0,29,18,4,0,4,0,0,0
3484,3949,1627579,23,17,1990,2,female,236.0,2,2,0,1,0,1,0,0
3485,36495,1409494,19,11,1994,8,male,187.0,53,34,0,2,0,2,0,0
3486,34395,1761193,23,17,1990,8,female,153.0,47,38,209,322,193,226,16,96
3487,36398,1064941,63,10,1950,1,female,27.0,51,50,333,128,52,72,281,56
3488,90258,1045615,36,16,1977,5,male,1264.0,508,372,7,51,3,23,4,28
3489,56223,1490340,24,14,1989,1,female,453.0,102,43,293,50,293,41,0,9
3490,41088,1151262,18,15,1995,8,male,44.0,64,52,0,1,0,1,0,0
3491,26517,1644319,22,15,1991,1,male,1093.0,34,25,0,1,0,1,0,0
3492,71252,1600642,59,6,1954,4,male,802.0,190,125,0,0,0,0,0,0
3493,96463,2057628,100,7,1913,8,female,1059.0,1014,374,180,56,117,17,63,39
3494,10634,1830240,29,8,1984,7,female,187.0,9,5,18,7,18,6,0,1
3495,77431,1323700,108,2,1905,5,female,1054.0,239,104,7,3,7,3,0,0
3496,34339,1779286,21,30,1992,8,female,232.0,46,43,112,13,112,4,0,9
3497,27001,1712148,68,18,1945,8,male,97.0,34,29,2,17,2,12,0,5
3498,80103,1424251,15,11,1998,5,female,121.0,266,249,0,1,0,1,0,0
3499,50684,1165925,21,27,1992,6,male,464.0,86,82,6,6,0,3,6,3
3500,94291,1291953,19,7,1994,6,female,686.0,771,608,20,56,20,49,0,7
3501,35516,1110845,21,1,1992,1,male,321.0,51,49,0,0,0,0,0,0
3502,17654,2033916,62,29,1951,9,female,161.0,20,18,442,143,440,116,2,27
3503,44903,1541722,23,28,1990,4,female,583.0,69,55,84,41,84,38,0,3
3504,61035,1108182,57,20,1956,11,male,485.0,123,79,229,23,4,6,225,17
3505,56733,1524221,41,30,1972,9,female,163.0,107,93,15,40,15,35,0,5
3506,43277,1265681,55,6,1958,6,female,986.0,66,50,162,127,158,70,4,57
3507,4287,1453954,41,23,1972,9,female,28.0,2,1,0,0,0,0,0,0
3508,54267,2074621,39,10,1974,1,male,11.0,96,88,311,217,257,130,54,87
3509,41060,1051454,17,2,1996,2,male,526.0,62,47,0,0,0,0,0,0
3510,26628,1636199,32,30,1981,3,male,233.0,35,33,0,0,0,0,0,0
3511,72367,2121221,63,10,1950,7,female,1714.0,195,149,2,5,0,1,2,4
3512,67062,1881466,18,19,1995,2,female,248.0,153,77,174,93,174,93,0,0
3513,23933,1066305,58,19,1955,10,male,452.0,29,14,9,1,0,1,9,0
3514,61255,1239085,28,8,1985,2,male,308.0,125,101,0,12,0,1,0,11
3515,69727,1462541,18,2,1995,3,male,169.0,175,156,34,68,34,35,0,33
3516,51112,1916111,59,19,1954,11,female,994.0,87,40,123,19,2,6,121,13
3517,15086,2093165,25,10,1988,3,male,688.0,17,13,6,7,6,7,0,0
3518,16880,1838360,19,4,1994,9,male,444.0,20,15,2,2,0,0,2,2
3519,71390,1999225,32,20,1981,8,male,612.0,184,129,3,12,3,11,0,1
3520,93499,1388844,19,10,1994,9,female,590.0,704,168,79,217,74,63,5,154
3521,3169,2190133,53,22,1960,9,female,403.0,1,0,1,0,0,0,1,0
3522,84087,1635090,67,4,1946,10,female,689.0,314,180,1414,208,0,75,1414,133
3523,11881,1659844,40,17,1973,3,male,34.0,12,3,2,0,2,0,0,0
3524,23741,1171870,20,14,1993,8,male,114.0,30,27,3,1,0,1,3,0
3525,89623,1654842,35,3,1978,2,female,1112.0,451,188,83,67,6,42,77,25
3526,76002,1625884,63,10,1950,7,female,983.0,216,112,250,875,0,123,250,752
3527,62477,1312047,44,2,1969,9,male,1604.0,130,108,3,2,3,2,0,0
3528,35154,1610752,33,7,1980,7,female,116.0,48,45,33,43,33,33,0,10
3529,18633,1750398,40,4,1973,9,male,361.0,23,14,0,0,0,0,0,0
3530,57934,1603287,71,31,1942,12,female,1543.0,109,56,84,42,64,10,20,32
3531,78298,1415906,29,8,1984,8,male,1087.0,241,217,1,23,1,11,0,12
3532,32604,1884493,57,20,1956,5,female,231.0,44,38,0,0,0,0,0,0
3533,52900,1582938,57,12,1956,10,male,166.0,93,76,65,6,65,4,0,2
3534,63830,1792715,24,21,1989,10,male,88.0,139,127,42,57,18,22,24,35
3535,2921,1978218,45,13,1968,11,male,344.0,1,1,0,0,0,0,0,0
3536,36977,1824504,25,25,1988,7,female,204.0,52,19,9,1,9,1,0,0
3537,95117,1734593,94,2,1919,6,male,1259.0,897,214,2,7,2,5,0,2
3538,71716,1025537,63,5,1950,7,female,2066.0,184,89,45,227,11,121,34,106
3539,92571,1623755,27,4,1986,4,female,920.0,579,267,123,691,87,647,36,44
3540,41822,2115942,37,19,1976,11,female,272.0,62,35,14,11,14,7,0,4
3541,89448,1339042,22,4,1991,9,female,81.0,449,205,28,242,28,132,0,110
3542,49671,1714033,21,2,1992,2,male,628.0,83,19,5,3,5,0,0,3
3543,72685,1713807,23,9,1990,9,male,429.0,192,161,35,52,35,38,0,14
3544,48233,1039369,13,6,2000,4,female,183.0,81,35,0,34,0,18,0,16
3545,96379,1116097,22,13,1991,5,male,455.0,1041,624,104,73,59,34,45,39
3546,56542,1368250,29,16,1984,11,female,63.0,106,99,2,1,1,0,1,1
3547,65125,1767398,31,22,1982,8,male,392.0,140,73,1657,239,1158,90,499,149
3548,15836,2157097,27,14,1986,11,male,182.0,18,18,1,0,0,0,1,0
3549,14772,1764334,38,26,1975,10,female,470.0,17,3,1,0,1,0,0,0
3550,15722,1237504,34,25,1979,1,male,350.0,18,17,0,0,0,0,0,0
3551,91506,1022071,18,23,1995,1,female,219.0,534,369,71,105,71,95,0,10
3552,40635,2054824,29,24,1984,10,male,631.0,60,40,18,8,0,2,18,6
3553,95884,1899722,19,22,1994,2,male,516.0,888,633,1281,343,1281,281,0,62
3554,41759,1958649,24,19,1989,7,female,211.0,62,50,10,4,10,3,0,1
3555,44028,1011753,54,1,1959,11,female,965.0,67,43,62,51,7,10,55,41
3556,13366,1320002,46,17,1967,6,male,668.0,14,9,29,7,29,7,0,0
3557,8022,2083731,61,16,1952,10,male,19.0,7,7,1,2,0,1,1,1
3558,87280,1594490,103,21,1910,2,male,1002.0,390,72,4,173,0,46,4,127
3559,70945,1692614,29,25,1984,1,female,615.0,180,106,183,0,182,0,1,0
3560,11803,1116950,71,26,1942,8,male,1693.0,12,6,1,1,0,1,1,0
3561,92606,1350689,24,15,1989,4,male,374.0,624,549,143,364,143,282,0,82
3562,31705,1173235,15,30,1998,10,male,292.0,42,32,3,0,2,0,1,0
3563,59569,1574809,37,21,1976,5,female,172.0,119,49,5,15,5,15,0,0
3564,66851,2063185,63,20,1950,1,male,1426.0,152,57,54,11,54,7,0,4
3565,30593,1506418,15,10,1998,6,male,493.0,40,24,4,0,4,0,0,0
3566,93528,1281696,16,14,1997,10,male,487.0,686,615,93,71,93,70,0,1
3567,54131,1623875,42,8,1971,4,male,383.0,95,38,117,3,117,3,0,0
3568,88075,1954672,25,5,1988,10,female,1435.0,389,239,1638,835,487,381,1151,454
3569,83168,2057242,20,28,1993,5,male,644.0,306,111,0,0,0,0,0,0
3570,43885,1009052,34,20,1979,5,male,399.0,68,42,22,0,22,0,0,0
3571,71830,2148852,65,23,1948,11,male,2047.0,186,163,86,6,12,4,74,2
3572,80691,2012829,41,28,1972,8,female,212.0,264,158,57,272,44,100,13,172
3573,76564,1626434,25,6,1988,9,male,381.0,222,127,18,3,18,3,0,0
3574,16671,1555177,63,13,1950,10,male,1161.0,20,11,0,0,0,0,0,0
3575,50793,1857131,108,1,1905,1,male,1759.0,86,69,14,10,14,10,0,0
3576,28478,1992518,34,20,1979,12,male,331.0,38,7,0,0,0,0,0,0
3577,64058,1823535,68,29,1945,10,male,1688.0,136,48,211,234,203,130,8,104
3578,16067,1287408,16,6,1997,10,female,288.0,18,10,10,5,8,2,2,3
3579,28981,1968903,57,28,1956,2,female,687.0,38,20,9,0,9,0,0,0
3580,33957,1169175,39,23,1974,7,male,145.0,47,44,7,0,7,0,0,0
3581,30012,2151381,54,15,1959,4,female,341.0,39,27,104,93,101,55,3,38
3582,1618,1380487,60,1,1953,9,male,660.0,0,0,0,0,0,0,0,0
3583,16926,2089767,25,4,1988,12,male,413.0,19,3,2,3,2,2,0,1
3584,84083,1900692,53,12,1960,6,female,2096.0,317,190,1160,1717,475,792,685,925
3585,95205,1440517,15,26,1998,9,female,261.0,897,580,14,32,14,32,0,0
3586,19701,2010618,22,8,1991,12,female,461.0,23,6,182,9,182,5,0,4
3587,33864,1613914,35,15,1978,4,male,443.0,47,19,4,1,0,1,4,0
3588,70075,1155275,61,28,1952,9,male,673.0,175,28,486,93,19,65,467,28
3589,31570,2101666,21,10,1992,8,male,135.0,43,27,1,0,1,0,0,0
3590,63472,1487858,21,2,1992,10,male,332.0,138,68,2,1,2,1,0,0
3591,16358,2165216,20,19,1993,5,male,70.0,20,16,0,0,0,0,0,0
3592,98193,1885919,71,25,1942,4,male,824.0,3090,567,42,184,0,36,42,148
3593,21464,1789276,52,5,1961,5,male,877.0,27,20,0,2,0,1,0,1
3594,14229,2014430,33,21,1980,5,female,153.0,15,14,175,163,175,152,0,11
3595,82385,1462691,22,4,1991,3,female,837.0,291,58,8,0,8,0,0,0
3596,73233,1905469,48,16,1965,6,male,456.0,201,104,0,23,0,13,0,10
3597,26557,2038376,26,3,1987,11,male,284.0,34,9,0,0,0,0,0,0
3598,28017,1087738,34,9,1979,1,male,591.0,36,12,8,16,4,15,4,1
3599,71361,1854019,85,14,1928,12,female,493.0,186,150,2,9,2,8,0,1
3600,40785,1416791,34,2,1979,6,female,668.0,61,26,62,27,62,22,0,5
3601,32091,1356254,28,1,1985,2,male,22.0,42,27,31,24,31,23,0,1
3602,30629,1778247,59,26,1954,6,male,452.0,40,37,5,13,0,3,5,10
3603,27421,1046766,22,4,1991,4,male,429.0,35,19,35,34,16,16,19,18
3604,15187,1006996,63,9,1950,3,female,422.0,17,11,11,1,11,1,0,0
3605,43708,1295926,17,21,1996,9,male,51.0,67,54,4,1,4,1,0,0
3606,65942,1641612,47,7,1966,11,female,1707.0,148,77,94,84,94,59,0,25
3607,25757,1572136,21,10,1992,7,male,109.0,33,20,4,7,0,4,4,3
3608,56178,1631230,67,28,1946,8,female,801.0,101,39,208,28,0,1,208,27
3609,93804,2046382,19,15,1994,5,female,664.0,688,355,446,1562,446,1510,0,52
3610,28776,1331739,23,9,1990,6,male,86.0,37,7,3,0,0,0,3,0
3611,35372,1955425,68,2,1945,5,male,996.0,49,27,195,5,106,4,89,1
3612,49171,1001262,47,18,1966,5,female,289.0,80,28,236,223,0,70,236,153
3613,94988,1705214,22,16,1991,8,female,531.0,796,631,2270,1083,1832,832,438,251
3614,84059,1318365,21,10,1992,3,male,475.0,308,156,805,397,805,151,0,246
3615,3682,2112679,60,2,1953,6,male,665.0,1,0,36,3,0,3,36,0
3616,55326,1432678,26,15,1987,5,male,154.0,101,77,0,0,0,0,0,0
3617,50250,2126387,66,24,1947,11,female,1938.0,84,21,538,169,538,153,0,16
3618,51206,1949292,16,24,1997,9,female,293.0,86,39,270,39,270,31,0,8
3619,96666,1899032,18,24,1995,2,male,233.0,1030,715,458,1914,424,1185,34,729
3620,9982,1664281,57,28,1956,9,male,453.0,10,6,0,0,0,0,0,0
3621,75834,1564612,106,15,1907,6,male,1184.0,214,152,92,98,85,73,7,25
3622,62460,1657970,108,18,1905,12,male,2399.0,134,92,3,0,0,0,3,0
3623,14880,1883570,25,25,1988,5,female,848.0,16,14,2,0,2,0,0,0
3624,48082,1764639,51,11,1962,5,female,519.0,77,45,87,78,0,52,87,26
3625,11792,1360567,48,15,1965,11,male,464.0,12,9,1,0,0,0,1,0
3626,73695,1418555,60,5,1953,9,female,1272.0,199,52,52,67,51,40,1,27
3627,39838,1785901,65,23,1948,2,female,347.0,59,51,29,34,29,30,0,4
3628,61789,2088643,17,12,1996,1,male,683.0,126,88,44,14,27,7,17,7
3629,79861,1045581,23,27,1990,8,female,327.0,254,192,202,137,13,38,189,99
3630,41714,1793373,49,11,1964,1,male,149.0,63,50,8,2,8,0,0,2
3631,45332,2130011,18,23,1995,8,male,89.0,73,60,1,0,1,0,0,0
3632,62035,1647634,24,4,1989,2,male,387.0,129,58,200,97,0,7,200,90
3633,36067,1123902,24,26,1989,9,male,21.0,51,41,21,6,18,6,3,0
3634,4849,1920555,30,1,1983,10,male,47.0,2,1,53,10,53,10,0,0
3635,83321,1105912,22,21,1991,5,female,314.0,305,275,4,4,0,0,4,4
3636,34153,2171439,23,18,1990,9,male,521.0,47,32,28,15,28,6,0,9
3637,28719,1168654,62,4,1951,1,male,442.0,37,31,2,2,0,0,2,2
3638,44338,1148507,32,25,1981,9,male,416.0,70,41,0,0,0,0,0,0
3639,52940,1938108,56,5,1957,1,male,1458.0,93,32,81,81,81,12,0,69
3640,82271,1171066,18,14,1995,5,male,241.0,297,281,2,2,2,1,0,1
3641,38518,1881521,22,5,1991,1,male,520.0,56,44,1,0,0,0,1,0
3642,48454,1569114,33,26,1980,6,male,343.0,81,66,1,0,1,0,0,0
3643,9605,1715003,24,15,1989,10,male,50.0,9,6,0,0,0,0,0,0
3644,89247,2015485,19,8,1994,9,male,316.0,453,281,2,11,2,10,0,1
3645,17619,1801874,33,5,1980,10,male,610.0,20,6,200,72,200,54,0,18
3646,13840,2122270,26,2,1987,2,female,622.0,15,13,1,0,1,0,0,0
3647,19427,1461133,16,11,1997,3,male,69.0,22,19,22,2,22,2,0,0
3648,1113,1546837,33,6,1980,5,female,470.0,0,0,0,0,0,0,0,0
3649,42545,1222078,25,6,1988,9,male,199.0,66,66,0,0,0,0,0,0
3650,27844,1975636,16,10,1997,2,female,177.0,36,34,1,0,1,0,0,0
3651,55209,1956349,46,13,1967,6,female,1844.0,98,45,527,974,176,698,351,276
3652,58841,1036567,21,14,1992,2,male,160.0,112,50,52,24,34,18,18,6
3653,97676,1511094,15,11,1998,8,female,425.0,1658,380,648,2269,411,1537,237,732
3654,84913,2022720,64,30,1949,7,female,1703.0,337,152,383,62,353,37,30,25
3655,63852,1986808,30,14,1983,11,male,1079.0,138,84,46,5,46,4,0,1
3656,44835,1402535,16,24,1997,3,female,90.0,70,56,46,58,46,53,0,5
3657,20761,2053602,59,4,1954,3,female,230.0,25,23,1,1,1,1,0,0
3658,29885,1231577,21,14,1992,4,female,21.0,39,32,22,31,22,26,0,5
3659,8979,1668815,59,29,1954,9,male,644.0,8,8,0,0,0,0,0,0
3660,10942,2038549,29,17,1984,11,male,80.0,11,11,0,0,0,0,0,0
3661,45918,1208125,62,18,1951,10,female,153.0,72,61,42,276,27,140,15,136
3662,17284,1469411,31,1,1982,6,male,57.0,19,17,13,1,13,0,0,1
3663,15886,1568431,55,20,1958,10,female,211.0,18,14,1,0,1,0,0,0
3664,60671,2001688,79,18,1934,7,female,1713.0,123,44,13,7,3,5,10,2
3665,78382,1954749,17,10,1996,2,female,327.0,245,152,4,11,4,2,0,9
3666,12943,1865714,23,1,1990,1,male,403.0,14,12,3,8,0,0,3,8
3667,51287,2045111,100,9,1913,11,female,1445.0,86,42,1785,193,1785,123,0,70
3668,64862,1558993,26,7,1987,3,female,328.0,142,95,69,140,69,70,0,70
3669,66648,1385199,107,2,1906,3,male,1378.0,151,107,13,4,12,1,1,3
3670,88764,1915187,28,10,1985,10,male,156.0,431,392,166,360,40,191,126,169
3671,16935,1389546,41,12,1972,11,male,846.0,19,14,2,9,2,7,0,2
3672,56296,1248500,35,16,1978,6,female,294.0,101,68,959,881,283,558,676,323
3673,29841,1861976,17,1,1996,1,female,102.0,39,15,13,9,0,5,13,4
3674,58408,1767129,20,28,1993,3,male,353.0,115,66,2,4,0,4,2,0
3675,71253,1997205,59,20,1954,5,female,744.0,183,100,0,0,0,0,0,0
3676,8820,1274616,25,31,1988,5,male,329.0,8,8,0,7,0,0,0,7
3677,52215,2183423,27,27,1986,10,female,1363.0,89,54,595,603,205,406,390,197
3678,67075,1278712,58,25,1955,2,female,1449.0,151,101,192,153,192,75,0,78
3679,88247,1019429,19,18,1994,5,female,423.0,418,162,2,5,2,4,0,1
3680,31133,1166661,37,11,1976,4,female,593.0,40,29,120,33,120,16,0,17
3681,8757,1120465,21,2,1992,2,male,224.0,8,4,0,19,0,11,0,8
3682,26539,2060616,23,15,1990,10,male,462.0,34,19,0,2,0,0,0,2
3683,51444,1642127,14,14,1999,3,female,188.0,89,20,1,0,1,0,0,0
3684,71172,1309469,20,13,1993,1,female,746.0,183,104,0,0,0,0,0,0
3685,19668,1955332,27,3,1986,2,female,684.0,22,15,122,70,122,61,0,9
3686,15918,2047822,59,4,1954,12,male,30.0,18,5,2,6,0,0,2,6
3687,78599,1979526,108,1,1905,1,male,2218.0,249,77,30,93,13,39,17,54
3688,45342,1547603,29,4,1984,9,male,301.0,72,56,1,0,1,0,0,0
3689,24566,1441875,24,17,1989,8,male,306.0,31,27,0,0,0,0,0,0
3690,50421,1683541,35,8,1978,12,female,466.0,87,46,0,0,0,0,0,0
3691,54038,1929357,30,22,1983,8,female,257.0,97,55,70,41,48,26,22,15
3692,25986,1186255,50,7,1963,4,female,610.0,32,21,13,0,13,0,0,0
3693,25176,2019988,17,3,1996,1,male,558.0,33,20,0,0,0,0,0,0
3694,61580,1574723,51,12,1962,3,female,353.0,128,127,10,3,0,1,10,2
3695,35480,1903093,17,8,1996,7,male,273.0,50,41,0,0,0,0,0,0
3696,52655,1375958,57,16,1956,6,male,732.0,93,71,8,27,8,12,0,15
3697,68349,1090834,23,25,1990,4,male,503.0,169,121,1,0,1,0,0,0
3698,65682,1264345,15,3,1998,10,male,224.0,148,106,20,8,20,5,0,3
3699,98004,1299284,15,29,1998,3,female,437.0,3820,1834,0,778,0,123,0,655
3700,40433,1154551,51,26,1962,4,male,1802.0,60,10,4,2,2,1,2,1
3701,20555,1628218,23,7,1990,8,male,292.0,25,19,0,0,0,0,0,0
3702,23317,1492482,32,1,1981,1,male,1042.0,30,25,0,5,0,3,0,2
3703,97526,1047626,17,1,1996,1,female,637.0,1589,601,312,208,111,105,201,103
3704,61446,1349924,25,16,1988,4,male,468.0,129,106,3,53,3,26,0,27
3705,64793,1427016,36,18,1977,4,female,148.0,140,98,42,44,42,28,0,16
3706,88600,1045240,15,14,1998,7,male,390.0,423,157,70,26,32,14,38,12
3707,38622,1918599,19,1,1994,1,female,171.0,57,42,3,9,0,3,3,6
3708,91413,1411390,21,11,1992,2,female,378.0,534,300,36,88,36,60,0,28
3709,12711,1443973,47,7,1966,8,male,1349.0,13,8,1,23,0,10,1,13
3710,46396,1742244,27,7,1986,11,male,460.0,74,47,0,0,0,0,0,0
3711,84730,1004880,32,28,1981,9,female,228.0,323,268,98,148,72,56,26,92
3712,49368,1225572,24,2,1989,2,male,584.0,82,59,0,0,0,0,0,0
3713,5614,1795728,19,8,1994,7,male,373.0,3,1,7,4,7,3,0,1
3714,2454,1743714,26,1,1987,1,male,385.0,1,0,0,0,0,0,0,0
3715,90032,1397402,108,7,1905,3,female,1612.0,474,236,1445,1069,0,156,1445,913
3716,90153,1097237,68,12,1945,11,female,1403.0,498,120,0,1,0,1,0,0
3717,65537,1179700,21,6,1992,6,male,317.0,148,86,7,20,0,5,7,15
3718,65240,2114033,26,1,1987,1,male,382.0,150,95,0,0,0,0,0,0
3719,31312,1677330,20,1,1993,1,male,34.0,42,30,0,0,0,0,0,0
3720,75583,1323189,14,22,1999,5,male,179.0,218,97,22,10,22,6,0,4
3721,15805,2024463,63,18,1950,2,male,252.0,18,14,0,0,0,0,0,0
3722,62534,2120764,18,21,1995,10,male,290.0,130,89,5,0,5,0,0,0
3723,90543,1087672,20,2,1993,4,female,338.0,510,133,71,8,62,5,9,3
3724,6434,1727502,18,25,1995,6,male,60.0,4,3,24,0,24,0,0,0
3725,66883,1447443,32,2,1981,3,male,248.0,153,134,67,24,67,17,0,7
3726,96975,1353893,19,1,1994,11,male,305.0,1092,238,10803,7748,901,3919,9902,3829
3727,31061,1965357,23,10,1990,8,female,534.0,41,18,70,35,44,23,26,12
3728,62417,1929068,71,20,1942,6,male,1494.0,134,72,2,0,0,0,2,0
3729,3709,2142658,24,3,1989,7,female,31.0,1,1,53,19,51,19,2,0
3730,30032,1822794,56,22,1957,5,female,271.0,39,24,152,12,148,6,4,6
3731,60320,1064110,21,26,1992,5,female,579.0,121,68,0,3,0,2,0,1
3732,10718,2152434,67,9,1946,11,male,1123.0,9,7,41,5,41,3,0,2
3733,58971,1449750,24,21,1989,11,female,163.0,115,73,122,29,122,15,0,14
3734,30855,1170143,49,10,1964,9,male,100.0,41,10,20,24,19,15,1,9
3735,8617,1325603,34,21,1979,8,male,440.0,7,6,68,7,68,4,0,3
3736,1076,1489408,32,21,1981,9,female,134.0,0,0,0,0,0,0,0,0
3737,11886,1882163,16,10,1997,12,male,17.0,12,11,2,3,2,1,0,2
3738,79352,1173080,38,26,1975,8,female,627.0,261,137,5,12,5,2,0,10
3739,68552,2108673,27,12,1986,12,male,417.0,165,98,8,22,8,20,0,2
3740,74593,1754984,18,26,1995,10,male,95.0,210,199,26,11,14,6,12,5
3741,47647,1074154,52,20,1961,5,male,780.0,78,19,1,37,0,14,1,23
3742,83013,1608999,33,23,1980,4,female,436.0,300,216,608,613,608,476,0,137
3743,55715,1465049,59,3,1954,12,female,155.0,101,70,10,17,0,10,10,7
3744,49353,1011653,22,1,1991,7,male,439.0,83,57,0,6,0,6,0,0
3745,56407,1039312,28,27,1985,3,male,225.0,106,86,0,1,0,0,0,1
3746,82634,1787154,20,5,1993,1,male,397.0,294,176,49,73,37,30,12,43
3747,96651,1562152,27,7,1986,8,male,597.0,1111,562,439,472,439,291,0,181
3748,4650,1849137,25,1,1988,1,female,9.0,2,2,3,0,3,0,0,0
3749,8128,1236660,31,2,1982,5,male,82.0,7,5,2,1,0,0,2,1
3750,39448,1241081,25,8,1988,8,male,447.0,59,47,1,0,1,0,0,0
3751,79834,1859131,17,9,1996,9,female,407.0,251,140,164,396,158,182,6,214
3752,89372,1837948,15,5,1998,9,female,405.0,455,63,13,3,13,3,0,0
3753,68092,1397476,69,13,1944,6,female,1152.0,161,101,399,242,387,171,12,71
3754,16814,1656860,22,1,1991,3,female,334.0,19,13,1,1,1,1,0,0
3755,8556,1259980,25,15,1988,3,female,173.0,7,6,29,4,29,1,0,3
3756,2355,1664154,24,18,1989,2,male,594.0,1,0,0,0,0,0,0,0
3757,5210,1545264,36,1,1977,1,male,124.0,3,3,0,0,0,0,0,0
3758,84791,1434213,17,16,1996,5,female,397.0,322,204,159,45,124,24,35,21
3759,17603,1350243,22,3,1991,7,female,789.0,20,16,156,6,107,6,49,0
3760,31657,1404280,64,12,1949,7,female,1619.0,42,9,2,0,2,0,0,0
3761,79129,1540698,18,30,1995,5,male,107.0,259,129,0,0,0,0,0,0
3762,72436,1929478,97,30,1916,9,male,788.0,192,115,4,1,0,0,4,1
3763,40147,1030004,17,12,1996,1,male,178.0,61,41,0,0,0,0,0,0
3764,47348,1289847,84,9,1929,2,female,1797.0,74,22,226,10,226,5,0,5
3765,34895,1889213,37,27,1976,4,female,211.0,49,16,5,0,5,0,0,0
3766,96223,2052550,21,5,1992,5,female,495.0,1048,613,20,359,9,178,11,181
3767,62543,1632888,18,24,1995,1,female,229.0,132,91,6,4,1,1,5,3
3768,55735,1841353,35,1,1978,1,male,493.0,103,19,11,1,11,1,0,0
3769,55457,1986772,22,21,1991,4,male,571.0,102,87,1,1,1,1,0,0
3770,62563,2146812,25,5,1988,7,male,220.0,130,105,6,117,6,93,0,24
3771,60016,1330312,25,19,1988,4,female,914.0,119,40,107,175,91,46,16,129
3772,4875,1204311,24,9,1989,4,female,432.0,2,2,97,10,0,0,97,10
3773,63563,2180300,29,21,1984,4,female,665.0,137,97,6,7,6,6,0,1
3774,1091,2046423,33,1,1980,1,male,311.0,0,0,0,0,0,0,0,0
3775,83979,1413221,26,12,1987,6,male,328.0,308,206,431,472,431,392,0,80
3776,64202,1966398,41,4,1972,3,female,673.0,137,96,1402,92,1402,68,0,24
3777,29952,1360157,27,19,1986,7,female,263.0,39,27,52,14,52,9,0,5
3778,61340,1562580,28,12,1985,8,male,1306.0,125,104,1,0,1,0,0,0
3779,12593,2128436,56,29,1957,7,female,797.0,14,11,0,1,0,1,0,0
3780,9809,1900582,36,20,1977,10,female,306.0,9,7,0,0,0,0,0,0
3781,95510,1900471,18,4,1995,10,male,530.0,991,330,181,685,80,358,101,327
3782,4981,1158352,20,15,1993,9,male,324.0,3,3,0,1,0,1,0,0
3783,38475,1626533,48,21,1965,10,male,1336.0,56,40,0,0,0,0,0,0
3784,98378,2033463,18,24,1995,6,female,551.0,3014,1028,226,3037,182,1809,44,1228
3785,92877,1704085,105,8,1908,6,male,563.0,607,452,594,101,594,86,0,15
3786,60945,1859439,60,6,1953,1,female,1009.0,123,65,108,114,108,73,0,41
3787,64394,1020165,25,1,1988,1,male,500.0,143,91,1,0,1,0,0,0
3788,98300,1804255,18,17,1995,10,female,682.0,3989,260,119,596,119,460,0,136
3789,52667,1850173,30,24,1983,5,female,377.0,93,37,9,20,9,13,0,7
3790,5443,1114599,34,28,1979,12,female,619.0,3,1,1,0,1,0,0,0
3791,62677,1303101,30,27,1983,6,male,392.0,131,100,16,13,0,2,16,11
3792,1434,1214037,45,17,1968,10,male,50.0,0,0,0,0,0,0,0,0
3793,36439,1437821,63,29,1950,10,female,206.0,51,23,1172,351,0,96,1172,255
3794,20074,2131973,30,27,1983,7,male,636.0,24,19,2,2,2,0,0,2
3795,47367,1716819,18,3,1995,5,female,42.0,76,52,286,122,286,82,0,40
3796,84755,1487499,45,9,1968,2,male,1107.0,332,110,121,140,121,64,0,76
3797,25599,2186016,29,10,1984,3,female,150.0,32,23,1,2,1,1,0,1
3798,15453,1219068,53,26,1960,11,female,639.0,17,14,80,49,76,44,4,5
3799,15445,1701824,28,11,1985,1,female,218.0,17,5,74,12,72,8,2,4
3800,21617,1640092,19,1,1994,1,male,46.0,26,18,1,0,1,0,0,0
3801,70995,1962103,62,6,1951,10,female,1933.0,180,89,271,164,181,66,90,98
3802,706,1987183,25,8,1988,8,male,216.0,0,0,0,0,0,0,0,0
3803,28866,1788402,20,20,1993,1,male,221.0,38,25,5,0,0,0,5,0
3804,77426,1829311,21,13,1992,12,female,474.0,235,145,7,69,5,56,2,13
3805,74932,1962038,24,3,1989,6,male,361.0,206,134,223,7,223,4,0,3
3806,2310,1301501,23,21,1990,4,male,221.0,1,1,0,0,0,0,0,0
3807,94900,1441616,27,2,1986,4,male,126.0,724,698,905,973,905,882,0,91
3808,57447,1748754,63,30,1950,11,male,826.0,108,58,3,3,0,3,3,0
3809,8863,1238252,29,12,1984,7,male,341.0,8,8,0,0,0,0,0,0
3810,59939,1313616,17,3,1996,11,male,239.0,116,74,63,37,63,10,0,27
3811,54350,1278174,36,11,1977,3,female,460.0,96,49,1168,195,1168,174,0,21
3812,50717,1178129,27,2,1986,4,male,104.0,86,62,8,10,7,7,1,3
3813,36364,1004820,58,7,1955,10,female,225.0,51,46,191,96,191,61,0,35
3814,66309,1590229,24,5,1989,4,male,187.0,153,119,0,0,0,0,0,0
3815,26507,2110068,20,28,1993,8,male,297.0,35,19,0,12,0,7,0,5
3816,40344,1103817,60,21,1953,5,male,695.0,61,34,2,2,0,2,2,0
3817,997,1880758,32,26,1981,12,female,9.0,0,0,0,0,0,0,0,0
3818,98388,1324261,19,5,1994,5,female,1554.0,3874,1618,243,1046,190,457,53,589
3819,97284,1846182,15,8,1998,3,male,495.0,1448,1120,56,53,17,20,39,33
3820,28066,1059113,69,23,1944,7,female,296.0,36,28,15,5,0,2,15,3
3821,21024,1841428,29,20,1984,2,male,128.0,25,24,34,30,34,24,0,6
3822,55711,1923345,19,11,1994,1,female,20.0,102,50,9,48,9,33,0,15
3823,23431,1677867,53,19,1960,2,male,222.0,29,19,0,17,0,12,0,5
3824,82664,1055811,21,5,1992,10,female,245.0,303,153,59,97,59,63,0,34
3825,1166,2014389,36,15,1977,11,female,661.0,0,0,0,0,0,0,0,0
3826,12117,1033385,41,14,1972,7,female,265.0,12,9,59,7,59,5,0,2
3827,16397,1836006,23,7,1990,6,male,217.0,20,8,0,0,0,0,0,0
3828,26713,1419652,53,26,1960,5,female,145.0,34,18,0,0,0,0,0,0
3829,23446,1915374,57,10,1956,2,male,731.0,29,13,0,0,0,0,0,0
3830,71938,1176500,63,13,1950,4,female,1243.0,185,151,166,199,14,76,152,123
3831,78781,1063311,29,20,1984,6,male,365.0,241,203,97,35,20,11,77,24
3832,1737,1094716,20,1,1993,1,female,1.0,0,0,1,0,1,0,0,0
3833,47077,2169003,20,17,1993,11,male,310.0,75,27,35,17,13,15,22,2
3834,49165,1535975,70,4,1943,5,female,1756.0,79,37,213,164,213,86,0,78
3835,56401,1635032,26,2,1987,7,female,547.0,106,64,0,17,0,7,0,10
3836,7641,1958891,32,29,1981,1,female,213.0,6,3,0,0,0,0,0,0
3837,38692,2009566,18,23,1995,5,female,471.0,57,39,5,5,5,5,0,0
3838,23556,2108823,56,5,1957,4,female,813.0,29,25,1,15,0,2,1,13
3839,31521,1718826,18,10,1995,9,male,195.0,43,37,1,0,0,0,1,0
3840,18675,2119354,51,19,1962,8,male,1241.0,23,4,0,0,0,0,0,0
3841,72008,1492341,18,16,1995,10,male,179.0,186,133,262,160,262,89,0,71
3842,38609,1736017,40,15,1973,7,female,340.0,57,43,2,11,2,7,0,4
3843,66220,1308629,21,12,1992,11,male,88.0,150,145,1439,200,1439,147,0,53
3844,21963,2140111,23,11,1990,12,male,317.0,27,24,8,1,8,0,0,1
3845,81580,1181963,16,7,1997,10,female,329.0,277,129,44,43,44,10,0,33
3846,45869,1062680,69,4,1944,4,male,789.0,73,58,34,27,0,6,34,21
3847,69673,1937642,51,19,1962,5,female,385.0,174,130,23,329,23,121,0,208
3848,79828,1868753,23,2,1990,5,female,882.0,259,71,162,403,3,115,159,288
3849,37464,1156711,19,2,1994,9,female,438.0,54,14,0,0,0,0,0,0
3850,37730,1062979,24,22,1989,5,male,373.0,55,39,3,11,3,9,0,2
3851,40749,2188607,20,1,1993,1,male,159.0,60,53,46,5,46,3,0,2
3852,50784,1957581,16,14,1997,1,male,581.0,85,57,13,24,13,21,0,3
3853,46031,1277718,27,18,1986,10,male,638.0,72,48,81,58,81,42,0,16
3854,76355,1387075,23,11,1990,2,male,732.0,226,68,2,9,2,8,0,1
3855,47671,1337960,17,27,1996,10,female,191.0,78,6,1,1,1,1,0,0
3856,35369,1617709,22,19,1991,6,female,128.0,49,20,188,145,188,145,0,0
3857,67418,1406488,65,20,1948,8,female,888.0,162,107,1,2,1,2,0,0
3858,65816,1671983,23,9,1990,3,male,438.0,146,74,45,25,45,17,0,8
3859,28332,1973360,17,5,1996,10,female,233.0,38,31,0,3,0,2,0,1
3860,68212,2049727,17,28,1996,7,male,471.0,169,56,0,0,0,0,0,0
3861,38451,1236427,34,9,1979,9,male,224.0,56,36,0,1,0,1,0,0
3862,72979,1416275,22,4,1991,2,female,617.0,193,83,278,212,278,177,0,35
3863,51632,1350033,24,2,1989,3,male,631.0,89,52,6,0,1,0,5,0
3864,57436,1180353,29,29,1984,2,male,225.0,110,49,2,16,2,13,0,3
3865,61980,1517359,19,19,1994,4,male,268.0,129,101,127,51,117,43,10,8
3866,7544,1768041,26,25,1987,10,male,237.0,7,5,0,0,0,0,0,0
3867,20921,2062625,93,12,1920,9,male,202.0,25,22,10,13,0,6,10,7
3868,60302,1063647,19,4,1994,4,male,860.0,122,65,0,0,0,0,0,0
3869,16813,1222284,21,19,1992,5,male,135.0,20,15,1,1,1,1,0,0
3870,51720,2081420,21,11,1992,10,male,429.0,90,24,11,21,0,15,11,6
3871,10293,1215383,49,5,1964,2,female,45.0,10,3,2,1,2,0,0,1
3872,4063,1927602,27,14,1986,9,female,409.0,2,1,0,0,0,0,0,0
3873,32758,1918740,18,1,1995,1,female,153.0,44,23,2,4,2,4,0,0
3874,49686,1573613,61,17,1952,2,male,473.0,82,69,6,8,0,5,6,3
3875,37097,1406933,18,8,1995,1,male,289.0,53,25,25,0,18,0,7,0
3876,1426,1991988,45,16,1968,6,male,540.0,0,0,0,0,0,0,0,0
3877,89167,1195500,25,12,1988,5,male,1211.0,445,361,0,1,0,1,0,0
3878,74477,1078999,22,15,1991,6,female,396.0,212,61,11,35,11,16,0,19
3879,15432,1637581,25,17,1988,7,male,151.0,16,15,66,0,66,0,0,0
3880,78223,1165290,27,6,1986,9,male,488.0,243,163,0,0,0,0,0,0
3881,11652,1349641,30,12,1983,1,female,510.0,12,1,0,0,0,0,0,0
3882,83505,1063866,36,14,1977,7,female,615.0,317,204,25,5,25,5,0,0
3883,92143,1903856,26,4,1987,3,male,309.0,577,467,2,0,2,0,0,0
3884,32159,1620022,30,20,1983,3,female,475.0,42,25,53,40,48,8,5,32
3885,53325,1285211,53,1,1960,3,female,202.0,94,73,0,0,0,0,0,0
3886,75419,1183211,57,27,1956,3,female,1473.0,219,20,7,14,5,4,2,10
3887,74339,1178563,26,10,1987,5,male,399.0,206,132,3,40,3,35,0,5
3888,45121,1973659,21,22,1992,11,male,47.0,72,68,0,0,0,0,0,0
3889,93256,1969227,27,30,1986,7,male,190.0,704,653,10,2,5,0,5,2
3890,18911,1936174,52,18,1961,9,male,336.0,23,18,1,2,1,2,0,0
3891,5616,2182840,20,25,1993,4,male,176.0,3,0,8,0,0,0,8,0
3892,13905,1544093,35,11,1978,5,male,404.0,15,14,2,0,2,0,0,0
3893,37377,2048193,58,18,1955,10,female,207.0,53,27,309,145,309,116,0,29
3894,3220,1270214,23,10,1990,10,male,3.0,1,1,1,0,1,0,0,0
3895,50131,2177288,40,19,1973,1,female,53.0,84,73,132,169,49,149,83,20
3896,16828,1536324,17,18,1996,9,male,52.0,19,16,1,2,1,0,0,2
3897,2807,1798282,37,5,1976,5,male,278.0,1,1,0,0,0,0,0,0
3898,68336,2070096,19,4,1994,4,male,88.0,163,101,1,109,0,77,1,32
3899,84049,1381438,14,25,1999,2,female,279.0,316,180,783,284,754,129,29,155
3900,32074,2150882,35,13,1978,3,male,819.0,43,22,28,77,16,36,12,41
3901,40462,1247929,17,14,1996,8,male,42.0,60,55,5,26,1,18,4,8
3902,2256,1903195,22,16,1991,7,male,285.0,1,1,0,0,0,0,0,0
3903,16259,2032430,73,29,1940,2,male,1276.0,18,12,145,70,82,54,63,16
3904,43017,1683865,28,26,1985,9,female,564.0,66,49,21,101,20,60,1,41
3905,56429,2171470,34,25,1979,10,male,413.0,107,42,0,11,0,9,0,2
3906,33623,2174496,50,22,1963,5,male,206.0,46,35,0,12,0,4,0,8
3907,45067,1207075,58,17,1955,3,female,1481.0,69,25,2480,1653,0,366,2480,1287
3908,95918,1151745,18,18,1995,10,female,457.0,878,435,1856,1157,1313,508,543,649
3909,79078,1322200,37,25,1976,11,female,555.0,242,167,1979,1832,807,547,1172,1285
3910,21441,1583049,48,7,1965,8,female,834.0,27,13,0,0,0,0,0,0
3911,50924,1635827,17,18,1996,10,female,515.0,85,33,33,39,32,34,1,5
3912,81300,1539193,20,2,1993,8,female,566.0,275,84,4,0,4,0,0,0
3913,37685,2125429,25,1,1988,1,female,31.0,54,45,2,32,2,30,0,2
3914,24540,1201069,21,11,1992,4,male,185.0,31,28,0,0,0,0,0,0
3915,74106,2105482,15,3,1998,5,female,210.0,208,107,0,0,0,0,0,0
3916,34020,1376607,13,7,2000,1,male,247.0,47,27,11,3,1,3,10,0
3917,86737,1468938,24,3,1989,6,male,281.0,368,314,122,181,122,145,0,36
3918,84406,2065312,18,22,1995,2,female,645.0,329,226,11,1,0,1,11,0
3919,78158,1673022,16,28,1997,1,female,236.0,243,1,0,0,0,0,0,0
3920,87650,1342360,107,3,1906,5,female,547.0,394,219,83,30,83,27,0,3
3921,48842,1781135,35,22,1978,1,male,263.0,79,49,24,22,0,7,24,15
3922,42191,2148230,62,16,1951,10,female,418.0,63,49,79,44,77,38,2,6
3923,56251,2120766,15,25,1998,1,female,145.0,103,54,371,401,371,302,0,99
3924,27019,1008556,23,15,1990,1,male,699.0,34,25,3,2,2,1,1,1
3925,54134,1049254,66,5,1947,5,female,1112.0,97,55,124,27,9,5,115,22
3926,67514,1837528,18,9,1995,5,male,287.0,162,148,5,0,5,0,0,0
3927,77515,2077017,13,2,2000,3,female,225.0,231,98,15,12,15,8,0,4
3928,277,1498375,19,4,1994,4,male,0.0,0,0,0,0,0,0,0,0
3929,90371,1929681,103,9,1910,7,female,484.0,503,165,22,22,22,20,0,2
3930,75013,1432899,15,22,1998,5,female,434.0,211,117,431,375,363,93,68,282
3931,9769,1993431,35,9,1978,12,male,307.0,10,9,0,0,0,0,0,0
3932,9519,1869977,20,21,1993,10,female,494.0,10,6,0,0,0,0,0,0
3933,93838,2180393,57,30,1956,9,male,273.0,653,368,552,430,536,211,16,219
3934,55618,1432520,56,21,1957,11,male,232.0,102,57,5,34,0,8,5,26
3935,67699,1840812,20,19,1993,6,female,531.0,158,84,24,41,24,19,0,22
3936,48615,1691492,23,4,1990,7,male,228.0,79,49,5,11,5,6,0,5
3937,77008,1346983,15,5,1998,5,male,170.0,223,199,375,113,375,86,0,27
3938,96210,1705857,20,26,1993,2,male,616.0,1084,891,17,25,17,23,0,2
3939,55003,1693005,20,25,1993,12,male,43.0,98,71,72,154,72,128,0,26
3940,37175,1763681,27,3,1986,6,female,282.0,53,41,42,72,42,72,0,0
3941,40709,1671225,95,5,1918,6,female,87.0,61,49,35,287,1,150,34,137
3942,89142,1533681,19,6,1994,7,male,643.0,474,189,0,9,0,9,0,0
3943,87374,1073121,48,5,1965,3,male,823.0,382,123,10,39,5,14,5,25
3944,78892,1374572,21,23,1992,11,female,28.0,241,37,231,96,231,57,0,39
3945,15969,2084554,33,15,1980,5,male,28.0,18,13,3,1,3,0,0,1
3946,20062,1547113,45,8,1968,1,male,507.0,24,7,2,0,2,0,0,0
3947,50191,2023809,24,25,1989,6,female,330.0,84,66,228,164,175,122,53,42
3948,88602,2051771,21,27,1992,4,female,1318.0,427,207,70,71,28,11,42,60
3949,90300,1844445,16,9,1997,4,male,452.0,490,372,10,6,9,4,1,2
3950,22366,1014491,59,30,1954,9,female,502.0,27,15,111,55,111,34,0,21
3951,60785,1060225,14,6,1999,10,female,300.0,124,103,32,28,32,17,0,11
3952,57076,1079270,46,24,1967,2,female,459.0,107,17,312,128,312,78,0,50
3953,83884,1577216,20,22,1993,10,female,257.0,312,289,269,303,27,64,242,239
3954,6309,1500957,34,10,1979,12,female,8.0,4,4,3,0,3,0,0,0
3955,77491,2143214,31,23,1982,9,female,1187.0,236,166,12,7,5,3,7,4
3956,79061,1970980,55,21,1958,4,female,1727.0,245,157,1433,426,1316,168,117,258
3957,72568,1272002,25,1,1988,4,male,264.0,196,73,15,4,15,3,0,1
3958,48418,1464212,23,12,1990,3,female,406.0,80,59,1,0,0,0,1,0
3959,6774,1264988,40,6,1973,5,male,286.0,5,4,0,0,0,0,0,0
3960,59290,1372272,24,10,1989,9,male,240.0,116,92,0,0,0,0,0,0
3961,81366,1943167,24,22,1989,12,male,612.0,285,171,7,53,7,45,0,8
3962,40954,2163162,32,27,1981,8,male,152.0,60,38,241,161,241,42,0,119
3963,47091,1714758,82,7,1931,11,female,787.0,74,29,39,4,18,3,21,1
3964,669,1761441,25,1,1988,1,male,7.0,0,0,0,0,0,0,0,0
3965,26271,1104401,25,14,1988,5,female,342.0,32,18,61,9,0,2,61,7
3966,90995,2128944,18,6,1995,5,female,647.0,511,228,1424,872,1362,695,62,177
3967,76859,1024669,23,17,1990,8,female,373.0,230,198,123,466,123,354,0,112
3968,91837,2100005,15,3,1998,8,female,522.0,559,226,502,1348,123,248,379,1100
3969,3161,1269357,39,6,1974,9,male,85.0,1,1,1,0,0,0,1,0
3970,93907,2080720,14,27,1999,7,female,172.0,681,404,870,754,478,464,392,290
3971,1288,1032217,39,8,1974,5,female,433.0,0,0,0,0,0,0,0,0
3972,62533,2168276,16,21,1997,12,male,632.0,130,50,5,0,5,0,0,0
3973,20441,1546937,26,30,1987,7,male,830.0,24,19,108,48,103,43,5,5
3974,3878,1978884,19,14,1994,10,male,16.0,2,2,0,0,0,0,0,0
3975,84485,1333749,31,30,1982,5,male,1171.0,331,148,21,11,7,2,14,9
3976,33079,1800239,50,17,1963,12,male,247.0,45,21,21,5,0,0,21,5
3977,41269,1592275,48,26,1965,10,female,298.0,64,47,0,1,0,1,0,0
3978,32920,1102091,21,17,1992,6,female,257.0,45,17,7,13,7,11,0,2
3979,23898,1183132,29,5,1984,12,male,112.0,29,22,7,2,7,1,0,1
3980,89304,1348564,18,14,1995,7,female,414.0,476,355,5,99,5,63,0,36
3981,14944,1563335,60,18,1953,12,male,14.0,16,14,3,2,0,2,3,0
3982,20660,1175279,51,26,1962,6,female,512.0,25,13,0,0,0,0,0,0
3983,6573,1178802,21,21,1992,1,male,302.0,5,5,0,0,0,0,0,0
3984,5648,1443924,35,8,1978,11,female,55.0,3,3,12,8,12,6,0,2
3985,51258,1748993,34,20,1979,4,male,93.0,87,83,494,67,494,50,0,17
3986,62382,1560963,27,15,1986,12,male,914.0,133,95,1,0,1,0,0,0
3987,76558,1035955,94,11,1919,5,female,934.0,228,98,17,28,17,25,0,3
3988,22656,1395742,108,31,1905,12,female,104.0,28,2,1,1,0,1,1,0
3989,98734,1255972,14,5,1999,5,female,183.0,2375,553,1178,2165,1093,764,85,1401
3990,82127,1796352,17,11,1996,3,male,1027.0,294,84,0,150,0,74,0,76
3991,5877,1837151,22,7,1991,9,male,158.0,4,3,0,0,0,0,0,0
3992,21270,1361249,23,3,1990,4,female,997.0,26,21,0,0,0,0,0,0
3993,54815,1818583,27,20,1986,8,female,426.0,99,78,18,8,18,7,0,1
3994,77984,1632293,49,6,1964,9,female,1224.0,232,96,297,407,80,152,217,255
3995,82004,1570716,58,9,1955,12,female,1396.0,284,245,583,314,166,272,417,42
3996,63580,1697631,19,15,1994,7,male,249.0,135,103,7,0,7,0,0,0
3997,18895,1930308,24,14,1989,4,male,140.0,22,17,1,10,1,10,0,0
3998,73946,2041719,31,25,1982,12,female,585.0,198,67,297,290,289,103,8,187
3999,91057,1673612,19,1,1994,6,female,726.0,490,71,4288,1243,2112,401,2176,842
